date ,Organisme ,service ,moins de 1 an ,plus de 75 ans ,entre 1 et 75 ans ,TOTAL passages ,hospitalisés ,UHCD ,Transferts 
28/02/2013,CCOM,CCOM Chirurgie,0,0,18,18,2,0,0
28/02/2013,CH Altkirch,Upatou,0,8,33,41,7,2,3
28/02/2013,CH de Colmar (CMC Le Parc),SAU Le Parc,5,0,32,37,6,0,0
28/02/2013,CH de Colmar (Louis Pasteur),SAU Pasteur,0,25,94,119,20,6,1
28/02/2013,CH de Guebwiller,UHTCD,0,1,41,42,3,3,2
28/02/2013,CH de Mulhouse ( Hasenrain),PEDIATRIE NEONATOLOGIE,13,0,17,30,6,1,1
28/02/2013,CH de Mulhouse (Emile Muller-Moenschberg,URGENCES,0,25,100,125,13,12,4
28/02/2013,CH de Saverne,S.A.U. (ADULTES),0,16,45,61,16,7,1
28/02/2013,CH de Saverne,PEDIATRIE,2,0,13,15,3,2,0
28/02/2013,CH de Sélestat,Acceuil des urgences,1,14,66,81,15,4,1
28/02/2013,CH de Thann,Urgences,0,5,29,34,3,3,2
28/02/2013,CH de Wissembourg,Urgences ,0,8,26,34,5,2,0
28/02/2013,CHU de Strasbourg (Hôp. Civil),Urgences Médico-Chirurgicales NHC,0,16,67,83,50,3,1
28/02/2013,CHU de Strasbourg(Hautepierre),Urgences chirurgicales pédiatriques,1,0,18,19,3,3,0
28/02/2013,CHU de Strasbourg(Hautepierre),Urgences chirurgicales pédiatriques,10,0,30,40,4,3,0
28/02/2013,CHU de Strasbourg(Hautepierre),Gynéco-Obstétrique (HTP),0,0,16,16,7,0,0
28/02/2013,CHU de Strasbourg(Hautepierre),Urgences Adulte HTP,0,19,79,98,35,0,0
28/02/2013,Clinique des 3 Frontières,UPATOU (Structure des urgences),0,7,38,45,6,0,2
28/02/2013,Clinique Ste Odile (Strasbourg,UPATOU,0,7,57,64,1,11,4
28/02/2013,CMCO,GYNECO-OBSTETRIQUE,0,0,0,0,0,0,0
28/02/2013,SIHCUS/CMCO,GYNECOLOGIE ET OBSTETRIQUE - CMCO,0,0,0,0,0,0,0
27/02/2013,CCOM,CCOM Chirurgie,0,1,17,18,0,0,0
27/02/2013,CH Altkirch,Upatou,0,2,24,26,0,0,2
27/02/2013,CH de Colmar (CMC Le Parc),SAU Le Parc,4,0,32,36,8,0,0
27/02/2013,CH de Colmar (Louis Pasteur),SAU Pasteur,0,21,89,110,21,15,0
27/02/2013,CH de Guebwiller,UHTCD,0,3,33,36,1,2,0
27/02/2013,CH de Mulhouse ( Hasenrain),PEDIATRIE NEONATOLOGIE,16,0,15,31,9,1,0
27/02/2013,CH de Mulhouse (Emile Muller-Moenschberg,URGENCES,0,19,84,103,11,14,1
27/02/2013,CH de Saverne,S.A.U. (ADULTES),0,12,34,46,10,7,2
27/02/2013,CH de Saverne,PEDIATRIE,9,0,21,30,5,2,1
27/02/2013,CH de Sélestat,Acceuil des urgences,2,10,55,67,13,4,2
27/02/2013,CH de Thann,Urgences,0,8,17,25,4,1,0
27/02/2013,CHU de Strasbourg (Hôp. Civil),Urgences Médico-Chirurgicales NHC,0,20,56,76,48,1,0
27/02/2013,CHU de Strasbourg(Hautepierre),Urgences chirurgicales pédiatriques,21,0,41,62,10,10,0
27/02/2013,CHU de Strasbourg(Hautepierre),Urgences Adulte HTP,0,22,67,89,36,0,0
27/02/2013,CHU de Strasbourg(Hautepierre),Gynéco-Obstétrique (HTP),0,0,35,35,12,0,0
27/02/2013,CHU de Strasbourg(Hautepierre),Urgences chirurgicales pédiatriques,2,0,24,26,1,1,0
27/02/2013,Clinique des 3 Frontières,UPATOU (Structure des urgences),0,7,34,41,7,0,0
27/02/2013,Clinique Ste Odile (Strasbourg,UPATOU,0,7,47,54,1,7,1
27/02/2013,CMCO,GYNECO-OBSTETRIQUE,0,0,0,0,0,0,0
27/02/2013,SIHCUS/CMCO,GYNECOLOGIE ET OBSTETRIQUE - CMCO,0,0,0,0,0,0,0
26/02/2013,CCOM,CCOM Chirurgie,0,0,26,26,3,0,0
26/02/2013,CH Altkirch,Upatou,0,6,28,34,1,3,1
26/02/2013,CH de Colmar (CMC Le Parc),SAU Le Parc,9,0,31,40,7,0,0
26/02/2013,CH de Colmar (Louis Pasteur),SAU Pasteur,0,25,91,116,17,7,1
26/02/2013,CH de Guebwiller,UHTCD,0,2,30,32,1,1,1
26/02/2013,CH de Mulhouse ( Hasenrain),PEDIATRIE NEONATOLOGIE,5,0,24,29,4,1,0
26/02/2013,CH de Mulhouse (Emile Muller-Moenschberg,URGENCES,0,20,77,97,16,8,4
26/02/2013,CH de Saverne,S.A.U. (ADULTES),0,12,35,47,7,6,2
26/02/2013,CH de Saverne,PEDIATRIE,5,0,25,30,2,2,0
26/02/2013,CH de Sélestat,Acceuil des urgences,2,12,55,69,14,5,0
26/02/2013,CH de Thann,Urgences,0,5,40,45,4,2,3
26/02/2013,CHU de Strasbourg (Hôp. Civil),Urgences Médico-Chirurgicales NHC,0,15,52,67,40,3,0
26/02/2013,CHU de Strasbourg(Hautepierre),Urgences chirurgicales pédiatriques,18,0,38,56,11,11,0
26/02/2013,CHU de Strasbourg(Hautepierre),Gynéco-Obstétrique (HTP),0,0,27,27,14,0,0
26/02/2013,CHU de Strasbourg(Hautepierre),Urgences Adulte HTP,0,23,75,98,43,0,0
26/02/2013,CHU de Strasbourg(Hautepierre),Urgences chirurgicales pédiatriques,1,0,36,37,3,3,0
26/02/2013,Clinique des 3 Frontières,UPATOU (Structure des urgences),0,5,38,43,4,0,0
26/02/2013,Clinique des Diaconesses,SOS Main,0,4,28,32,1,0,1
26/02/2013,Clinique Ste Odile (Strasbourg,UPATOU,0,2,55,57,2,6,1
26/02/2013,CMCO,GYNECO-OBSTETRIQUE,0,0,0,0,0,0,0
26/02/2013,SIHCUS/CMCO,GYNECOLOGIE ET OBSTETRIQUE - CMCO,0,0,0,0,0,0,0
25/02/2013,CCOM,CCOM Chirurgie,0,0,32,32,0,0,0
25/02/2013,CH Altkirch,Upatou,0,10,27,37,8,1,2
25/02/2013,CH de Colmar (CMC Le Parc),SAU Le Parc,16,0,35,51,12,0,0
25/02/2013,CH de Colmar (Louis Pasteur),SAU Pasteur,1,22,106,129,20,11,0
25/02/2013,CH de Guebwiller,UHTCD,0,4,36,40,3,2,6
25/02/2013,CH de Mulhouse ( Hasenrain),PEDIATRIE NEONATOLOGIE,12,0,35,47,9,1,0
25/02/2013,CH de Mulhouse (Emile Muller-Moenschberg,URGENCES,0,35,100,135,24,9,3
25/02/2013,CH de Saverne,S.A.U. (ADULTES),0,12,26,38,9,6,2
25/02/2013,CH de Saverne,PEDIATRIE,4,0,10,14,2,0,0
25/02/2013,CH de Sélestat,Acceuil des urgences,2,19,57,78,21,8,0
25/02/2013,CH de Thann,Urgences,0,9,41,50,5,3,1
25/02/2013,CHU de Strasbourg (Hôp. Civil),Urgences Médico-Chirurgicales NHC,0,21,49,70,43,4,0
25/02/2013,CHU de Strasbourg(Hautepierre),Urgences chirurgicales pédiatriques,2,0,25,27,2,2,0
25/02/2013,CHU de Strasbourg(Hautepierre),Urgences Adulte HTP,0,22,84,106,49,0,0
25/02/2013,CHU de Strasbourg(Hautepierre),Urgences chirurgicales pédiatriques,20,0,42,62,4,4,0
25/02/2013,CHU de Strasbourg(Hautepierre),Gynéco-Obstétrique (HTP),2,0,31,33,11,0,0
25/02/2013,Clinique des 3 Frontières,UPATOU (Structure des urgences),0,4,34,38,8,0,0
25/02/2013,Clinique des Diaconesses,SOS Main,0,3,33,36,1,0,0
25/02/2013,Clinique Ste Odile (Strasbourg,UPATOU,0,2,70,72,0,9,3
25/02/2013,CMCO,GYNECO-OBSTETRIQUE,0,0,0,0,0,0,0
25/02/2013,SIHCUS/CMCO,GYNECOLOGIE ET OBSTETRIQUE - CMCO,0,0,0,0,0,0,0
24/02/2013,CCOM,CCOM Chirurgie,0,0,19,19,6,0,0
24/02/2013,CH Altkirch,Upatou,0,6,29,35,4,1,1
24/02/2013,CH de Colmar (CMC Le Parc),SAU Le Parc,9,0,30,39,9,0,0
24/02/2013,CH de Colmar (Louis Pasteur),SAU Pasteur,0,22,92,114,18,7,0
24/02/2013,CH de Guebwiller,UHTCD,1,4,38,43,2,4,2
24/02/2013,CH de Mulhouse ( Hasenrain),PEDIATRIE NEONATOLOGIE,14,0,37,51,6,2,0
24/02/2013,CH de Mulhouse (Emile Muller-Moenschberg,URGENCES,0,17,116,133,19,8,0
24/02/2013,CH de Saverne,S.A.U. (ADULTES),0,9,39,48,5,5,1
24/02/2013,CH de Saverne,PEDIATRIE,6,0,15,21,3,2,0
24/02/2013,CH de Sélestat,Acceuil des urgences,4,9,57,70,15,2,1
24/02/2013,CH de Thann,Urgences,0,2,36,38,2,4,0
24/02/2013,CHU de Strasbourg (Hôp. Civil),Urgences Médico-Chirurgicales NHC,1,21,70,92,47,0,1
24/02/2013,CHU de Strasbourg(Hautepierre),Urgences chirurgicales pédiatriques,3,0,30,33,2,1,0
24/02/2013,CHU de Strasbourg(Hautepierre),Urgences chirurgicales pédiatriques,17,0,60,77,11,11,0
24/02/2013,CHU de Strasbourg(Hautepierre),Gynéco-Obstétrique (HTP),1,0,31,32,11,0,0
24/02/2013,CHU de Strasbourg(Hautepierre),Urgences Adulte HTP,0,21,58,79,39,0,2
24/02/2013,Clinique des 3 Frontières,UPATOU (Structure des urgences),0,5,44,49,7,0,0
24/02/2013,Clinique des Diaconesses,SOS Main,0,1,20,21,0,3,0
24/02/2013,Clinique Ste Odile (Strasbourg,UPATOU,0,4,56,60,0,1,2
24/02/2013,CMCO,GYNECO-OBSTETRIQUE,0,0,0,0,0,0,0
24/02/2013,SIHCUS/CMCO,GYNECOLOGIE ET OBSTETRIQUE - CMCO,0,0,0,0,0,0,0
23/02/2013,CCOM,CCOM Chirurgie,0,2,24,26,5,0,0
23/02/2013,CH de Colmar (CMC Le Parc),SAU Le Parc,5,0,37,42,6,0,0
23/02/2013,CH de Colmar (Louis Pasteur),SAU Pasteur,0,22,76,98,22,10,1
23/02/2013,CH de Guebwiller,UHTCD,1,5,34,40,1,1,0
23/02/2013,CH de Mulhouse ( Hasenrain),PEDIATRIE NEONATOLOGIE,5,0,30,35,1,1,0
23/02/2013,CH de Mulhouse (Emile Muller-Moenschberg,URGENCES,3,19,139,161,17,13,4
23/02/2013,CH de Saverne,PEDIATRIE,6,0,22,28,4,0,0
23/02/2013,CH de Saverne,S.A.U. (ADULTES),0,19,34,53,12,4,0
23/02/2013,CH de Sélestat,Acceuil des urgences,5,15,71,91,17,8,3
23/02/2013,CH de Thann,Urgences,0,10,41,51,1,2,3
23/02/2013,CHU de Strasbourg (Hôp. Civil),Urgences Médico-Chirurgicales NHC,0,12,87,99,35,2,3
23/02/2013,CHU de Strasbourg(Hautepierre),Urgences chirurgicales pédiatriques,2,0,36,38,2,2,0
23/02/2013,CHU de Strasbourg(Hautepierre),Urgences chirurgicales pédiatriques,26,0,48,74,9,9,0
23/02/2013,CHU de Strasbourg(Hautepierre),Gynéco-Obstétrique (HTP),0,0,23,23,8,0,0
23/02/2013,CHU de Strasbourg(Hautepierre),Urgences Adulte HTP,0,19,85,104,45,0,0
23/02/2013,Clinique des 3 Frontières,UPATOU (Structure des urgences),0,5,57,62,5,0,1
23/02/2013,Clinique des Diaconesses,SOS Main,1,2,25,28,0,6,0
23/02/2013,Clinique Ste Odile (Strasbourg,UPATOU,0,0,60,60,2,7,2
23/02/2013,CMCO,GYNECO-OBSTETRIQUE,0,0,0,0,0,0,0
23/02/2013,SIHCUS/CMCO,GYNECOLOGIE ET OBSTETRIQUE - CMCO,0,0,0,0,0,0,0
22/02/2013,CCOM,CCOM Chirurgie,0,0,23,23,2,0,0
22/02/2013,CH Altkirch,Upatou,0,2,27,29,2,1,1
22/02/2013,CH de Colmar (CMC Le Parc),SAU Le Parc,11,0,33,44,7,0,2
22/02/2013,CH de Colmar (Louis Pasteur),SAU Pasteur,0,22,117,139,28,10,8
22/02/2013,CH de Guebwiller,UHTCD,0,5,27,32,2,2,2
22/02/2013,CH de Mulhouse ( Hasenrain),PEDIATRIE NEONATOLOGIE,18,0,24,42,4,2,0
22/02/2013,CH de Mulhouse (Emile Muller-Moenschberg,URGENCES,0,31,92,123,16,11,2
22/02/2013,CH de Saverne,S.A.U. (ADULTES),0,14,18,32,14,3,3
22/02/2013,CH de Saverne,PEDIATRIE,4,0,20,24,3,1,0
22/02/2013,CH de Sélestat,Acceuil des urgences,1,12,53,66,12,4,2
22/02/2013,CH de Thann,Urgences,0,5,27,32,4,0,1
22/02/2013,CHU de Strasbourg (Hôp. Civil),Urgences Médico-Chirurgicales NHC,0,19,55,74,40,2,2
22/02/2013,CHU de Strasbourg(Hautepierre),Gynéco-Obstétrique (HTP),0,0,20,20,11,0,0
22/02/2013,CHU de Strasbourg(Hautepierre),Urgences chirurgicales pédiatriques,2,0,40,42,6,6,0
22/02/2013,CHU de Strasbourg(Hautepierre),Urgences Adulte HTP,0,14,62,76,36,0,1
22/02/2013,CHU de Strasbourg(Hautepierre),Urgences chirurgicales pédiatriques,21,0,54,75,7,7,0
22/02/2013,Clinique des 3 Frontières,UPATOU (Structure des urgences),1,9,27,37,3,0,0
22/02/2013,Clinique des Diaconesses,SOS Main,0,2,27,29,10,0,0
22/02/2013,Clinique Ste Odile (Strasbourg,UPATOU,0,7,53,60,1,8,4
22/02/2013,CMCO,GYNECO-OBSTETRIQUE,0,0,0,0,0,0,0
22/02/2013,SIHCUS/CMCO,GYNECOLOGIE ET OBSTETRIQUE - CMCO,0,0,0,0,0,0,0
21/02/2013,CCOM,CCOM Chirurgie,0,2,25,27,1,0,0
21/02/2013,CH Altkirch,Upatou,0,9,19,28,6,1,1
21/02/2013,CH de Colmar (CMC Le Parc),SAU Le Parc,8,0,45,53,9,0,0
21/02/2013,CH de Colmar (Louis Pasteur),SAU Pasteur,0,33,102,135,24,16,0
21/02/2013,CH de Guebwiller,UHTCD,0,6,33,39,2,1,2
21/02/2013,CH de Mulhouse ( Hasenrain),PEDIATRIE NEONATOLOGIE,21,0,20,41,6,2,1
21/02/2013,CH de Mulhouse (Emile Muller-Moenschberg,URGENCES,0,21,106,127,18,7,2
21/02/2013,CH de Saverne,S.A.U. (ADULTES),0,10,45,55,11,7,3
21/02/2013,CH de Saverne,PEDIATRIE,7,0,12,19,3,0,0
21/02/2013,CH de Sélestat,Acceuil des urgences,0,4,49,53,11,4,1
21/02/2013,CH de Thann,Urgences,0,7,36,43,2,1,4
21/02/2013,CH de Wissembourg,Urgences ,2,11,44,57,18,1,1
21/02/2013,CHU de Strasbourg (Hôp. Civil),Urgences Médico-Chirurgicales NHC,0,29,52,81,47,3,0
21/02/2013,CHU de Strasbourg(Hautepierre),Urgences chirurgicales pédiatriques,3,0,33,36,6,6,0
21/02/2013,CHU de Strasbourg(Hautepierre),Urgences Adulte HTP,0,14,73,87,28,0,0
21/02/2013,CHU de Strasbourg(Hautepierre),Urgences chirurgicales pédiatriques,12,0,46,58,6,6,0
21/02/2013,CHU de Strasbourg(Hautepierre),Gynéco-Obstétrique (HTP),0,0,20,20,7,0,0
21/02/2013,Clinique des 3 Frontières,UPATOU (Structure des urgences),3,7,39,49,3,0,0
21/02/2013,Clinique des Diaconesses,SOS Main,0,1,28,29,9,0,0
21/02/2013,Clinique Ste Odile (Strasbourg,UPATOU,0,7,66,73,3,10,2
21/02/2013,CMCO,GYNECO-OBSTETRIQUE,0,0,0,0,0,0,0
21/02/2013,SIHCUS/CMCO,GYNECOLOGIE ET OBSTETRIQUE - CMCO,0,0,0,0,0,0,0
20/02/2013,CCOM,CCOM Chirurgie,0,4,26,30,4,0,0
20/02/2013,CH Altkirch,Upatou,0,9,25,34,3,1,0
20/02/2013,CH de Colmar (CMC Le Parc),SAU Le Parc,10,0,42,52,6,0,0
20/02/2013,CH de Colmar (Louis Pasteur),SAU Pasteur,0,24,119,143,16,12,1
20/02/2013,CH de Guebwiller,UHTCD,0,3,25,28,2,2,0
20/02/2013,CH de Mulhouse ( Hasenrain),PEDIATRIE NEONATOLOGIE,10,0,18,28,6,3,0
20/02/2013,CH de Mulhouse (Emile Muller-Moenschberg,URGENCES,1,21,95,117,6,15,5
20/02/2013,CH de Saverne,S.A.U. (ADULTES),0,11,40,51,9,8,0
20/02/2013,CH de Saverne,PEDIATRIE,5,0,18,23,4,1,0
20/02/2013,CH de Sélestat,Acceuil des urgences,0,13,60,73,11,8,2
20/02/2013,CH de Thann,Urgences,0,7,27,34,1,1,6
20/02/2013,CH de Wissembourg,Urgences ,1,7,25,33,8,1,0
20/02/2013,CHU de Strasbourg (Hôp. Civil),Urgences Médico-Chirurgicales NHC,0,15,65,80,42,0,3
20/02/2013,CHU de Strasbourg(Hautepierre),Urgences chirurgicales pédiatriques,2,0,30,32,2,3,0
20/02/2013,CHU de Strasbourg(Hautepierre),Urgences chirurgicales pédiatriques,13,0,49,62,8,8,0
20/02/2013,CHU de Strasbourg(Hautepierre),Gynéco-Obstétrique (HTP),0,0,21,21,9,0,0
20/02/2013,CHU de Strasbourg(Hautepierre),Urgences Adulte HTP,0,18,64,82,36,0,1
20/02/2013,Clinique des 3 Frontières,UPATOU (Structure des urgences),1,5,35,41,4,0,1
20/02/2013,Clinique des Diaconesses,SOS Main,0,0,21,21,0,5,0
20/02/2013,Clinique Ste Odile (Strasbourg,UPATOU,0,5,53,58,1,3,1
20/02/2013,CMCO,GYNECO-OBSTETRIQUE,0,0,0,0,0,0,0
20/02/2013,SIHCUS/CMCO,GYNECOLOGIE ET OBSTETRIQUE - CMCO,0,0,0,0,0,0,0
19/02/2013,CCOM,CCOM Chirurgie,0,1,25,26,2,0,0
19/02/2013,CH Altkirch,Upatou,0,6,23,29,4,3,1
19/02/2013,CH de Colmar (CMC Le Parc),SAU Le Parc,11,0,37,48,7,1,0
19/02/2013,CH de Colmar (Louis Pasteur),SAU Pasteur,0,27,115,142,19,12,1
19/02/2013,CH de Guebwiller,UHTCD,0,2,34,36,2,1,5
19/02/2013,CH de Mulhouse ( Hasenrain),PEDIATRIE NEONATOLOGIE,12,0,24,36,3,1,0
19/02/2013,CH de Mulhouse (Emile Muller-Moenschberg,URGENCES,0,23,112,135,18,10,3
19/02/2013,CH de Saverne,S.A.U. (ADULTES),0,13,32,45,12,7,0
19/02/2013,CH de Saverne,PEDIATRIE,3,0,19,22,3,0,0
19/02/2013,CH de Sélestat,Acceuil des urgences,1,13,61,75,19,7,0
19/02/2013,CH de Thann,Urgences,0,9,26,35,5,0,1
19/02/2013,CH de Wissembourg,Urgences ,1,7,20,28,6,1,2
19/02/2013,CHU de Strasbourg (Hôp. Civil),Urgences Médico-Chirurgicales NHC,0,19,62,81,48,1,4
19/02/2013,CHU de Strasbourg(Hautepierre),Urgences chirurgicales pédiatriques,3,0,31,34,6,6,0
19/02/2013,CHU de Strasbourg(Hautepierre),Urgences Adulte HTP,0,16,83,99,44,0,1
19/02/2013,CHU de Strasbourg(Hautepierre),Urgences chirurgicales pédiatriques,16,0,46,62,12,11,0
19/02/2013,CHU de Strasbourg(Hautepierre),Gynéco-Obstétrique (HTP),0,0,24,24,10,0,0
19/02/2013,Clinique des 3 Frontières,UPATOU (Structure des urgences),0,6,32,38,9,0,2
19/02/2013,Clinique des Diaconesses,SOS Main,0,1,28,29,1,10,0
19/02/2013,Clinique Ste Odile (Strasbourg,UPATOU,1,3,55,59,2,9,1
19/02/2013,CMCO,GYNECO-OBSTETRIQUE,0,0,0,0,0,0,0
19/02/2013,SIHCUS/CMCO,GYNECOLOGIE ET OBSTETRIQUE - CMCO,0,0,0,0,0,0,0
18/02/2013,CCOM,CCOM Chirurgie,0,0,28,28,3,0,0
18/02/2013,CH Altkirch,Upatou,0,9,37,46,2,2,1
18/02/2013,CH de Colmar (CMC Le Parc),SAU Le Parc,11,0,51,62,7,0,0
18/02/2013,CH de Colmar (Louis Pasteur),SAU Pasteur,0,21,124,145,16,12,0
18/02/2013,CH de Guebwiller,UHTCD,0,7,39,46,2,3,2
18/02/2013,CH de Mulhouse ( Hasenrain),PEDIATRIE NEONATOLOGIE,17,0,31,48,4,1,0
18/02/2013,CH de Mulhouse (Emile Muller-Moenschberg,URGENCES,0,26,104,130,15,12,4
18/02/2013,CH de Saverne,PEDIATRIE,3,0,26,29,4,2,0
18/02/2013,CH de Saverne,S.A.U. (ADULTES),0,15,36,51,9,7,0
18/02/2013,CH de Sélestat,Acceuil des urgences,3,13,73,89,20,7,2
18/02/2013,CH de Thann,Urgences,0,5,39,44,2,0,2
18/02/2013,CH de Wissembourg,Urgences ,0,10,23,33,10,1,0
18/02/2013,CHU de Strasbourg (Hôp. Civil),Urgences Médico-Chirurgicales NHC,0,27,63,90,51,6,1
18/02/2013,CHU de Strasbourg(Hautepierre),Urgences chirurgicales pédiatriques,15,0,42,57,9,9,0
18/02/2013,CHU de Strasbourg(Hautepierre),Gynéco-Obstétrique (HTP),0,0,29,29,18,0,0
18/02/2013,CHU de Strasbourg(Hautepierre),Urgences Adulte HTP,0,21,91,112,38,0,0
18/02/2013,CHU de Strasbourg(Hautepierre),Urgences chirurgicales pédiatriques,2,0,27,29,5,5,0
18/02/2013,Clinique des 3 Frontières,UPATOU (Structure des urgences),0,5,33,38,4,0,1
18/02/2013,Clinique des Diaconesses,SOS Main,0,1,33,34,1,7,0
18/02/2013,Clinique Ste Odile (Strasbourg,UPATOU,0,4,56,60,2,5,0
18/02/2013,CMCO,GYNECO-OBSTETRIQUE,0,0,0,0,0,0,0
18/02/2013,SIHCUS/CMCO,GYNECOLOGIE ET OBSTETRIQUE - CMCO,0,0,0,0,0,0,0
17/02/2013,CCOM,CCOM Chirurgie,0,0,21,21,1,0,0
17/02/2013,CH Altkirch,Upatou,0,5,36,41,6,1,1
17/02/2013,CH de Colmar (CMC Le Parc),SAU Le Parc,9,0,59,68,9,0,0
17/02/2013,CH de Colmar (Louis Pasteur),SAU Pasteur,0,24,119,143,26,14,0
17/02/2013,CH de Guebwiller,UHTCD,0,4,32,36,1,2,0
17/02/2013,CH de Mulhouse ( Hasenrain),PEDIATRIE NEONATOLOGIE,18,0,32,50,2,2,0
17/02/2013,CH de Mulhouse (Emile Muller-Moenschberg,URGENCES,1,18,113,132,12,11,2
17/02/2013,CH de Saverne,S.A.U. (ADULTES),0,7,34,41,8,6,2
17/02/2013,CH de Saverne,PEDIATRIE,5,0,15,20,3,0,0
17/02/2013,CH de Thann,Urgences,0,3,33,36,3,1,0
17/02/2013,CHU de Strasbourg (Hôp. Civil),Urgences Médico-Chirurgicales NHC,0,28,71,99,34,4,1
17/02/2013,CHU de Strasbourg(Hautepierre),Urgences chirurgicales pédiatriques,1,1,28,30,2,2,0
17/02/2013,CHU de Strasbourg(Hautepierre),Urgences chirurgicales pédiatriques,18,0,61,79,16,16,0
17/02/2013,CHU de Strasbourg(Hautepierre),Gynéco-Obstétrique (HTP),0,0,20,20,6,0,0
17/02/2013,CHU de Strasbourg(Hautepierre),Urgences Adulte HTP,0,13,82,95,26,0,0
17/02/2013,Clinique des 3 Frontières,UPATOU (Structure des urgences),0,4,43,47,4,0,0
17/02/2013,Clinique des Diaconesses,SOS Main,0,0,28,28,0,14,0
17/02/2013,Clinique Ste Odile (Strasbourg,UPATOU,2,4,88,94,2,4,1
17/02/2013,CMCO,GYNECO-OBSTETRIQUE,0,0,0,0,0,0,0
17/02/2013,SIHCUS/CMCO,GYNECOLOGIE ET OBSTETRIQUE - CMCO,0,0,0,0,0,0,0
16/02/2013,CCOM,CCOM Chirurgie,0,1,11,12,2,0,0
16/02/2013,CH Altkirch,Upatou,0,7,33,40,6,1,1
16/02/2013,CH de Colmar (CMC Le Parc),SAU Le Parc,12,0,45,57,8,0,0
16/02/2013,CH de Colmar (Louis Pasteur),SAU Pasteur,0,25,109,134,22,13,4
16/02/2013,CH de Guebwiller,UHTCD,0,4,51,55,2,5,7
16/02/2013,CH de Mulhouse ( Hasenrain),PEDIATRIE NEONATOLOGIE,18,0,31,49,1,3,0
16/02/2013,CH de Mulhouse (Emile Muller-Moenschberg,URGENCES,0,17,109,126,0,21,4
16/02/2013,CH de Saverne,S.A.U. (ADULTES),0,11,42,53,6,6,3
16/02/2013,CH de Saverne,PEDIATRIE,3,0,23,26,2,0,0
16/02/2013,CH de Sélestat,Acceuil des urgences,4,13,52,69,18,4,1
16/02/2013,CH de Thann,Urgences,0,6,35,41,4,2,2
16/02/2013,CHU de Strasbourg (Hôp. Civil),Urgences Médico-Chirurgicales NHC,0,19,85,104,49,3,0
16/02/2013,CHU de Strasbourg(Hautepierre),Urgences chirurgicales pédiatriques,0,0,27,27,1,1,0
16/02/2013,CHU de Strasbourg(Hautepierre),Urgences Adulte HTP,0,20,91,111,50,0,1
16/02/2013,CHU de Strasbourg(Hautepierre),Urgences chirurgicales pédiatriques,22,0,68,90,8,8,0
16/02/2013,CHU de Strasbourg(Hautepierre),Gynéco-Obstétrique (HTP),1,0,28,29,10,0,0
16/02/2013,Clinique des 3 Frontières,UPATOU (Structure des urgences),0,5,38,43,4,0,1
16/02/2013,Clinique des Diaconesses,SOS Main,0,0,34,34,0,0,0
16/02/2013,Clinique Ste Odile (Strasbourg,UPATOU,0,3,73,76,1,7,1
16/02/2013,CMCO,GYNECO-OBSTETRIQUE,0,0,0,0,0,0,0
16/02/2013,SIHCUS/CMCO,GYNECOLOGIE ET OBSTETRIQUE - CMCO,0,0,0,0,0,0,0
15/02/2013,CCOM,CCOM Chirurgie,0,1,15,16,3,0,0
15/02/2013,CH Altkirch,Upatou,0,4,8,12,1,25,2
15/02/2013,CH de Colmar (CMC Le Parc),SAU Le Parc,11,0,46,57,10,0,0
15/02/2013,CH de Colmar (Louis Pasteur),SAU Pasteur,0,29,103,132,26,11,4
15/02/2013,CH de Guebwiller,UHTCD,0,2,33,35,0,2,2
15/02/2013,CH de Mulhouse ( Hasenrain),PEDIATRIE NEONATOLOGIE,15,0,29,44,9,1,0
15/02/2013,CH de Mulhouse (Emile Muller-Moenschberg,URGENCES,2,26,123,151,18,10,2
15/02/2013,CH de Saverne,PEDIATRIE,3,0,17,20,2,1,0
15/02/2013,CH de Saverne,S.A.U. (ADULTES),0,9,36,45,9,4,0
15/02/2013,CH de Sélestat,Acceuil des urgences,2,14,70,86,25,3,4
15/02/2013,CH de Thann,Urgences,0,10,22,32,6,0,0
15/02/2013,CHU de Strasbourg (Hôp. Civil),Urgences Médico-Chirurgicales NHC,0,15,66,81,44,11,1
15/02/2013,CHU de Strasbourg(Hautepierre),Urgences chirurgicales pédiatriques,2,0,38,40,7,7,0
15/02/2013,CHU de Strasbourg(Hautepierre),Gynéco-Obstétrique (HTP),0,0,29,29,10,0,0
15/02/2013,CHU de Strasbourg(Hautepierre),Urgences Adulte HTP,0,15,81,96,36,0,0
15/02/2013,CHU de Strasbourg(Hautepierre),Urgences chirurgicales pédiatriques,15,0,42,57,3,2,0
15/02/2013,Clinique des 3 Frontières,UPATOU (Structure des urgences),0,5,38,43,8,0,0
15/02/2013,Clinique des Diaconesses,SOS Main,0,3,35,38,0,0,0
15/02/2013,Clinique Ste Odile (Strasbourg,UPATOU,0,4,57,61,1,8,3
15/02/2013,CMCO,GYNECO-OBSTETRIQUE,0,0,0,0,0,0,0
15/02/2013,SIHCUS/CMCO,GYNECOLOGIE ET OBSTETRIQUE - CMCO,0,0,0,0,0,0,0
14/02/2013,CCOM,CCOM Chirurgie,0,1,18,19,2,0,0
14/02/2013,CH Altkirch,Upatou,0,8,22,30,4,1,1
14/02/2013,CH de Colmar (CMC Le Parc),SAU Le Parc,12,0,43,55,9,0,0
14/02/2013,CH de Colmar (Louis Pasteur),SAU Pasteur,0,20,94,114,12,12,1
14/02/2013,CH de Guebwiller,UHTCD,0,7,35,42,1,5,2
14/02/2013,CH de Mulhouse ( Hasenrain),PEDIATRIE NEONATOLOGIE,11,0,16,27,6,0,0
14/02/2013,CH de Mulhouse (Emile Muller-Moenschberg,URGENCES,0,19,87,106,14,8,6
14/02/2013,CH de Saverne,S.A.U. (ADULTES),0,12,39,51,9,4,1
14/02/2013,CH de Saverne,PEDIATRIE,6,0,17,23,5,3,0
14/02/2013,CH de Sélestat,Acceuil des urgences,2,13,64,79,12,4,3
14/02/2013,CH de Thann,Urgences,0,3,30,33,2,1,0
14/02/2013,CHU de Strasbourg (Hôp. Civil),Urgences Médico-Chirurgicales NHC,0,17,48,65,44,0,2
14/02/2013,CHU de Strasbourg(Hautepierre),Urgences chirurgicales pédiatriques,0,0,47,47,5,5,0
14/02/2013,CHU de Strasbourg(Hautepierre),Urgences chirurgicales pédiatriques,14,0,51,65,8,6,0
14/02/2013,CHU de Strasbourg(Hautepierre),Gynéco-Obstétrique (HTP),0,0,21,21,12,0,0
14/02/2013,CHU de Strasbourg(Hautepierre),Urgences Adulte HTP,0,23,83,106,34,0,0
14/02/2013,Clinique des 3 Frontières,UPATOU (Structure des urgences),1,2,36,39,8,0,2
14/02/2013,Clinique des Diaconesses,SOS Main,0,3,36,39,0,20,0
14/02/2013,Clinique Ste Odile (Strasbourg,UPATOU,0,1,62,63,2,9,3
14/02/2013,CMCO,GYNECO-OBSTETRIQUE,0,0,0,0,0,0,0
14/02/2013,SIHCUS/CMCO,GYNECOLOGIE ET OBSTETRIQUE - CMCO,0,0,0,0,0,0,0
13/02/2013,CCOM,CCOM Chirurgie,0,0,24,24,5,0,0
13/02/2013,CH Altkirch,Upatou,0,5,32,37,2,2,1
13/02/2013,CH de Colmar (CMC Le Parc),SAU Le Parc,15,0,51,66,14,0,0
13/02/2013,CH de Colmar (Louis Pasteur),SAU Pasteur,0,22,98,120,24,11,1
13/02/2013,CH de Guebwiller,UHTCD,0,4,31,35,2,1,1
13/02/2013,CH de Mulhouse ( Hasenrain),PEDIATRIE NEONATOLOGIE,9,0,22,31,4,1,0
13/02/2013,CH de Mulhouse (Emile Muller-Moenschberg,URGENCES,0,31,86,117,11,9,4
13/02/2013,CH de Saverne,PEDIATRIE,2,0,16,18,2,3,0
13/02/2013,CH de Saverne,S.A.U. (ADULTES),0,9,35,44,11,5,0
13/02/2013,CH de Sélestat,Acceuil des urgences,5,12,61,78,10,3,2
13/02/2013,CH de Thann,Urgences,0,3,24,27,3,2,0
13/02/2013,CHU de Strasbourg (Hôp. Civil),Urgences Médico-Chirurgicales NHC,0,18,54,72,36,1,1
13/02/2013,CHU de Strasbourg(Hautepierre),Urgences chirurgicales pédiatriques,5,0,31,36,4,4,0
13/02/2013,CHU de Strasbourg(Hautepierre),Urgences chirurgicales pédiatriques,20,0,41,61,8,8,0
13/02/2013,CHU de Strasbourg(Hautepierre),Gynéco-Obstétrique (HTP),0,0,25,25,12,0,0
13/02/2013,CHU de Strasbourg(Hautepierre),Urgences Adulte HTP,0,21,68,89,43,0,2
13/02/2013,Clinique des 3 Frontières,UPATOU (Structure des urgences),1,9,34,44,5,0,0
13/02/2013,Clinique des Diaconesses,SOS Main,0,1,36,37,18,0,1
13/02/2013,Clinique Ste Odile (Strasbourg,UPATOU,0,5,60,65,3,9,1
13/02/2013,CMCO,GYNECO-OBSTETRIQUE,0,0,0,0,0,0,0
13/02/2013,SIHCUS/CMCO,GYNECOLOGIE ET OBSTETRIQUE - CMCO,0,0,0,0,0,0,0
12/02/2013,CCOM,CCOM Chirurgie,0,0,19,19,1,0,0
12/02/2013,CH Altkirch,Upatou,0,5,27,32,2,2,1
12/02/2013,CH de Colmar (CMC Le Parc),SAU Le Parc,11,0,43,54,3,0,0
12/02/2013,CH de Colmar (Louis Pasteur),SAU Pasteur,0,24,87,111,12,11,0
12/02/2013,CH de Guebwiller,UHTCD,0,2,31,33,2,3,1
12/02/2013,CH de Mulhouse ( Hasenrain),PEDIATRIE NEONATOLOGIE,10,0,24,34,7,1,0
12/02/2013,CH de Mulhouse (Emile Muller-Moenschberg,URGENCES,0,20,89,109,10,12,9
12/02/2013,CH de Saverne,S.A.U. (ADULTES),0,9,41,50,10,6,1
12/02/2013,CH de Saverne,PEDIATRIE,2,0,11,13,1,0,0
12/02/2013,CH de Sélestat,Acceuil des urgences,0,10,51,61,10,5,3
12/02/2013,CH de Thann,Urgences,0,2,32,34,0,4,0
12/02/2013,CH de Wissembourg,Urgences ,0,4,28,32,6,1,0
12/02/2013,CHU de Strasbourg (Hôp. Civil),Urgences Médico-Chirurgicales NHC,0,11,48,59,26,1,1
12/02/2013,CHU de Strasbourg(Hautepierre),Urgences chirurgicales pédiatriques,21,0,41,62,10,9,0
12/02/2013,CHU de Strasbourg(Hautepierre),Urgences chirurgicales pédiatriques,4,0,34,38,2,2,0
12/02/2013,CHU de Strasbourg(Hautepierre),Urgences Adulte HTP,0,19,64,83,33,0,1
12/02/2013,CHU de Strasbourg(Hautepierre),Gynéco-Obstétrique (HTP),2,0,23,25,15,0,0
12/02/2013,Clinique des 3 Frontières,UPATOU (Structure des urgences),0,8,32,40,6,0,0
12/02/2013,Clinique des Diaconesses,SOS Main,0,1,35,36,0,0,0
12/02/2013,Clinique Ste Odile (Strasbourg,UPATOU,1,1,58,60,0,13,3
12/02/2013,CMCO,GYNECO-OBSTETRIQUE,0,0,0,0,0,0,0
12/02/2013,SIHCUS/CMCO,GYNECOLOGIE ET OBSTETRIQUE - CMCO,0,0,0,0,0,0,0
11/02/2013,CCOM,CCOM Chirurgie,0,0,21,21,0,0,0
11/02/2013,CH Altkirch,Upatou,0,10,30,40,7,2,1
11/02/2013,CH de Colmar (CMC Le Parc),SAU Le Parc,7,0,51,58,7,0,0
11/02/2013,CH de Colmar (Louis Pasteur),SAU Pasteur,0,25,119,144,17,14,1
11/02/2013,CH de Guebwiller,UHTCD,0,7,37,44,2,2,1
11/02/2013,CH de Mulhouse ( Hasenrain),PEDIATRIE NEONATOLOGIE,10,0,31,41,6,1,0
11/02/2013,CH de Mulhouse (Emile Muller-Moenschberg,URGENCES,0,21,118,139,16,17,1
11/02/2013,CH de Saverne,S.A.U. (ADULTES),0,9,65,74,10,8,0
11/02/2013,CH de Saverne,PEDIATRIE,4,0,23,27,0,1,0
11/02/2013,CH de Sélestat,Acceuil des urgences,1,7,84,92,20,5,2
11/02/2013,CH de Thann,Urgences,0,9,28,37,2,3,0
11/02/2013,CH de Wissembourg,Urgences ,0,8,39,47,10,3,0
11/02/2013,CHU de Strasbourg (Hôp. Civil),Urgences Médico-Chirurgicales NHC,0,24,51,75,40,0,2
11/02/2013,CHU de Strasbourg(Hautepierre),Urgences chirurgicales pédiatriques,14,0,55,69,10,10,0
11/02/2013,CHU de Strasbourg(Hautepierre),Gynéco-Obstétrique (HTP),0,0,31,31,17,0,0
11/02/2013,CHU de Strasbourg(Hautepierre),Urgences chirurgicales pédiatriques,0,0,59,59,7,7,0
11/02/2013,CHU de Strasbourg(Hautepierre),Urgences Adulte HTP,0,15,85,100,35,0,1
11/02/2013,Clinique des 3 Frontières,UPATOU (Structure des urgences),0,6,50,56,5,0,1
11/02/2013,Clinique Ste Odile (Strasbourg,UPATOU,0,3,68,71,4,8,2
11/02/2013,CMCO,GYNECO-OBSTETRIQUE,0,0,0,0,0,0,0
11/02/2013,SIHCUS/CMCO,GYNECOLOGIE ET OBSTETRIQUE - CMCO,0,0,0,0,0,0,0
10/02/2013,CCOM,CCOM Chirurgie,0,2,24,26,8,0,0
10/02/2013,CH Altkirch,Upatou,1,2,43,46,1,2,1
10/02/2013,CH de Colmar (CMC Le Parc),SAU Le Parc,23,0,58,81,10,0,0
10/02/2013,CH de Colmar (Louis Pasteur),SAU Pasteur,0,19,99,118,20,14,0
10/02/2013,CH de Guebwiller,UHTCD,1,3,46,50,0,2,1
10/02/2013,CH de Mulhouse ( Hasenrain),PEDIATRIE NEONATOLOGIE,15,0,30,45,3,1,0
10/02/2013,CH de Mulhouse (Emile Muller-Moenschberg,URGENCES,0,30,101,131,14,11,4
10/02/2013,CH de Saverne,PEDIATRIE,9,0,24,33,4,1,0
10/02/2013,CH de Saverne,S.A.U. (ADULTES),0,6,39,45,3,5,1
10/02/2013,CH de Sélestat,Acceuil des urgences,4,11,74,89,10,6,2
10/02/2013,CH de Thann,Urgences,0,7,34,41,4,1,2
10/02/2013,CH de Wissembourg,Urgences ,1,1,34,36,3,3,0
10/02/2013,CHU de Strasbourg (Hôp. Civil),Urgences Médico-Chirurgicales NHC,0,17,72,89,42,0,3
10/02/2013,CHU de Strasbourg(Hautepierre),Urgences chirurgicales pédiatriques,3,0,38,41,2,3,0
10/02/2013,CHU de Strasbourg(Hautepierre),Urgences Adulte HTP,0,15,79,94,34,0,2
10/02/2013,CHU de Strasbourg(Hautepierre),Urgences chirurgicales pédiatriques,11,0,80,91,8,8,0
10/02/2013,CHU de Strasbourg(Hautepierre),Gynéco-Obstétrique (HTP),0,0,28,28,9,0,0
10/02/2013,Clinique des 3 Frontières,UPATOU (Structure des urgences),0,3,42,45,4,0,2
10/02/2013,Clinique des Diaconesses,SOS Main,0,1,32,33,12,2,1
10/02/2013,Clinique Ste Odile (Strasbourg,UPATOU,0,3,77,80,0,10,2
10/02/2013,CMCO,GYNECO-OBSTETRIQUE,0,0,0,0,0,0,0
10/02/2013,SIHCUS/CMCO,GYNECOLOGIE ET OBSTETRIQUE - CMCO,0,0,0,0,0,0,0
9/02/2013,CCOM,CCOM Chirurgie,0,1,20,21,3,0,0
9/02/2013,CH Altkirch,Upatou,0,6,37,43,5,1,1
9/02/2013,CH de Colmar (CMC Le Parc),SAU Le Parc,15,0,44,59,13,0,0
9/02/2013,CH de Colmar (Louis Pasteur),SAU Pasteur,0,27,118,145,24,10,4
9/02/2013,CH de Guebwiller,UHTCD,0,5,34,39,1,2,1
9/02/2013,CH de Mulhouse ( Hasenrain),PEDIATRIE NEONATOLOGIE,19,0,27,46,4,3,0
9/02/2013,CH de Mulhouse (Emile Muller-Moenschberg,URGENCES,2,32,123,157,8,14,4
9/02/2013,CH de Saverne,S.A.U. (ADULTES),0,11,36,47,11,5,0
9/02/2013,CH de Saverne,PEDIATRIE,4,0,23,27,3,1,0
9/02/2013,CH de Sélestat,Acceuil des urgences,3,11,65,79,15,5,2
9/02/2013,CH de Thann,Urgences,0,4,38,42,2,1,0
9/02/2013,CH de Wissembourg,Urgences ,1,5,19,25,7,0,1
9/02/2013,CHU de Strasbourg (Hôp. Civil),Urgences Médico-Chirurgicales NHC,0,16,76,92,35,0,1
9/02/2013,CHU de Strasbourg(Hautepierre),Urgences chirurgicales pédiatriques,2,0,36,38,5,4,0
9/02/2013,CHU de Strasbourg(Hautepierre),Urgences Adulte HTP,0,11,77,88,42,0,3
9/02/2013,CHU de Strasbourg(Hautepierre),Urgences chirurgicales pédiatriques,12,0,51,63,9,8,0
9/02/2013,CHU de Strasbourg(Hautepierre),Gynéco-Obstétrique (HTP),0,1,24,25,3,0,0
9/02/2013,Clinique des 3 Frontières,UPATOU (Structure des urgences),0,7,46,53,10,1,1
9/02/2013,Clinique des Diaconesses,SOS Main,0,1,23,24,7,0,0
9/02/2013,Clinique Ste Odile (Strasbourg,UPATOU,0,4,81,85,2,7,5
9/02/2013,CMCO,GYNECO-OBSTETRIQUE,0,0,0,0,0,0,0
9/02/2013,SIHCUS/CMCO,GYNECOLOGIE ET OBSTETRIQUE - CMCO,0,0,0,0,0,0,0
8/02/2013,CCOM,CCOM Chirurgie,0,4,33,37,2,0,0
8/02/2013,CH Altkirch,Upatou,0,4,34,38,5,1,0
8/02/2013,CH de Colmar (CMC Le Parc),SAU Le Parc,10,0,47,57,10,0,0
8/02/2013,CH de Colmar (Louis Pasteur),SAU Pasteur,0,25,90,115,27,8,2
8/02/2013,CH de Guebwiller,UHTCD,0,9,40,49,3,4,1
8/02/2013,CH de Mulhouse ( Hasenrain),PEDIATRIE NEONATOLOGIE,6,0,33,39,7,0,0
8/02/2013,CH de Mulhouse (Emile Muller-Moenschberg,URGENCES,4,21,109,134,15,11,5
8/02/2013,CH de Saverne,PEDIATRIE,5,0,13,18,1,0,0
8/02/2013,CH de Saverne,S.A.U. (ADULTES),0,11,43,54,17,3,0
8/02/2013,CH de Sélestat,Acceuil des urgences,1,13,65,79,19,5,2
8/02/2013,CH de Thann,Urgences,0,7,38,45,2,2,1
8/02/2013,CH de Wissembourg,Urgences ,0,6,21,27,6,0,0
8/02/2013,CHU de Strasbourg (Hôp. Civil),Urgences Médico-Chirurgicales NHC,0,20,63,83,38,1,3
8/02/2013,CHU de Strasbourg(Hautepierre),Urgences chirurgicales pédiatriques,2,0,44,46,3,3,0
8/02/2013,CHU de Strasbourg(Hautepierre),Urgences Adulte HTP,0,15,87,102,43,0,0
8/02/2013,CHU de Strasbourg(Hautepierre),Urgences chirurgicales pédiatriques,8,0,48,56,14,13,0
8/02/2013,CHU de Strasbourg(Hautepierre),Gynéco-Obstétrique (HTP),0,0,36,36,15,0,0
8/02/2013,Clinique des 3 Frontières,UPATOU (Structure des urgences),0,7,42,49,7,0,1
8/02/2013,Clinique des Diaconesses,SOS Main,0,2,19,21,5,0,0
8/02/2013,Clinique Ste Odile (Strasbourg,UPATOU,0,4,70,74,3,10,3
8/02/2013,CMCO,GYNECO-OBSTETRIQUE,0,0,0,0,0,0,0
8/02/2013,SIHCUS/CMCO,GYNECOLOGIE ET OBSTETRIQUE - CMCO,0,0,0,0,0,0,0
7/02/2013,CCOM,CCOM Chirurgie,0,1,24,25,6,0,0
7/02/2013,CH Altkirch,Upatou,0,1,28,29,3,0,1
7/02/2013,CH de Colmar (CMC Le Parc),SAU Le Parc,12,0,51,63,16,0,1
7/02/2013,CH de Colmar (Louis Pasteur),SAU Pasteur,0,21,105,126,17,12,0
7/02/2013,CH de Guebwiller,UHTCD,0,6,39,45,1,2,1
7/02/2013,CH de Mulhouse ( Hasenrain),PEDIATRIE NEONATOLOGIE,13,0,37,50,12,3,0
7/02/2013,CH de Mulhouse (Emile Muller-Moenschberg,URGENCES,0,19,116,135,9,12,5
7/02/2013,CH de Saverne,S.A.U. (ADULTES),0,7,37,44,12,4,1
7/02/2013,CH de Saverne,PEDIATRIE,5,0,16,21,4,1,0
7/02/2013,CH de Sélestat,Acceuil des urgences,1,14,53,68,20,4,1
7/02/2013,CH de Thann,Urgences,0,5,34,39,3,3,1
7/02/2013,CH de Wissembourg,Urgences ,1,6,32,39,6,0,0
7/02/2013,CHU de Strasbourg (Hôp. Civil),Urgences Médico-Chirurgicales NHC,0,18,57,75,32,2,1
7/02/2013,CHU de Strasbourg(Hautepierre),Urgences chirurgicales pédiatriques,1,0,44,45,3,3,0
7/02/2013,CHU de Strasbourg(Hautepierre),Urgences Adulte HTP,0,13,76,89,34,0,1
7/02/2013,CHU de Strasbourg(Hautepierre),Urgences chirurgicales pédiatriques,17,0,59,76,6,6,0
7/02/2013,CHU de Strasbourg(Hautepierre),Gynéco-Obstétrique (HTP),0,0,26,26,13,0,0
7/02/2013,Clinique des 3 Frontières,UPATOU (Structure des urgences),0,4,42,46,5,0,1
7/02/2013,Clinique Ste Odile (Strasbourg,UPATOU,0,2,58,60,0,4,1
7/02/2013,CMCO,GYNECO-OBSTETRIQUE,0,0,0,0,0,0,0
7/02/2013,SIHCUS/CMCO,GYNECOLOGIE ET OBSTETRIQUE - CMCO,0,0,0,0,0,0,0
6/02/2013,CCOM,CCOM Chirurgie,0,1,24,25,2,0,0
6/02/2013,CH Altkirch,Upatou,0,8,32,40,5,2,3
6/02/2013,CH de Colmar (CMC Le Parc),SAU Le Parc,6,0,51,57,8,0,0
6/02/2013,CH de Colmar (Louis Pasteur),SAU Pasteur,0,25,84,109,23,15,1
6/02/2013,CH de Guebwiller,UHTCD,0,4,24,28,1,1,0
6/02/2013,CH de Mulhouse ( Hasenrain),PEDIATRIE NEONATOLOGIE,10,0,29,39,3,0,0
6/02/2013,CH de Mulhouse (Emile Muller-Moenschberg,URGENCES,0,24,104,128,13,9,3
6/02/2013,CH de Saverne,PEDIATRIE,6,0,19,25,3,2,0
6/02/2013,CH de Saverne,S.A.U. (ADULTES),0,12,39,51,5,5,2
6/02/2013,CH de Sélestat,Acceuil des urgences,1,8,59,68,9,4,4
6/02/2013,CH de Thann,Urgences,0,5,23,28,5,1,0
6/02/2013,CH de Wissembourg,Urgences ,0,5,21,26,7,1,0
6/02/2013,CHU de Strasbourg (Hôp. Civil),Urgences Médico-Chirurgicales NHC,0,13,68,81,48,0,3
6/02/2013,CHU de Strasbourg(Hautepierre),Urgences chirurgicales pédiatriques,17,0,40,57,10,9,0
6/02/2013,CHU de Strasbourg(Hautepierre),Gynéco-Obstétrique (HTP),0,0,24,24,12,0,0
6/02/2013,CHU de Strasbourg(Hautepierre),Urgences chirurgicales pédiatriques,3,0,49,52,5,5,0
6/02/2013,CHU de Strasbourg(Hautepierre),Urgences Adulte HTP,0,16,70,86,39,0,0
6/02/2013,Clinique des 3 Frontières,UPATOU (Structure des urgences),1,6,41,48,6,0,0
6/02/2013,Clinique Ste Odile (Strasbourg,UPATOU,1,3,59,63,1,7,0
6/02/2013,CMCO,GYNECO-OBSTETRIQUE,0,0,0,0,0,0,0
6/02/2013,SIHCUS/CMCO,GYNECOLOGIE ET OBSTETRIQUE - CMCO,0,0,0,0,0,0,0
5/02/2013,CCOM,CCOM Chirurgie,0,6,22,28,7,0,0
5/02/2013,CH Altkirch,Upatou,0,6,22,28,5,1,2
5/02/2013,CH de Colmar (CMC Le Parc),SAU Le Parc,12,0,51,63,12,0,0
5/02/2013,CH de Colmar (Louis Pasteur),SAU Pasteur,0,23,97,120,23,14,2
5/02/2013,CH de Guebwiller,UHTCD,0,6,40,46,3,3,1
5/02/2013,CH de Mulhouse ( Hasenrain),PEDIATRIE NEONATOLOGIE,15,0,16,31,5,2,0
5/02/2013,CH de Mulhouse (Emile Muller-Moenschberg,URGENCES,0,20,98,118,13,6,5
5/02/2013,CH de Saverne,PEDIATRIE,2,0,20,22,2,0,0
5/02/2013,CH de Saverne,S.A.U. (ADULTES),0,9,50,59,11,5,0
5/02/2013,CH de Sélestat,Acceuil des urgences,2,7,70,79,18,5,0
5/02/2013,CH de Thann,Urgences,1,8,30,39,2,1,1
5/02/2013,CH de Wissembourg,Urgences ,0,6,35,41,8,1,2
5/02/2013,CHU de Strasbourg (Hôp. Civil),Urgences Médico-Chirurgicales NHC,0,18,75,93,52,1,2
5/02/2013,CHU de Strasbourg(Hautepierre),Urgences chirurgicales pédiatriques,4,0,54,58,5,5,0
5/02/2013,CHU de Strasbourg(Hautepierre),Urgences Adulte HTP,0,19,83,102,46,0,0
5/02/2013,CHU de Strasbourg(Hautepierre),Urgences chirurgicales pédiatriques,8,0,61,69,9,8,0
5/02/2013,CHU de Strasbourg(Hautepierre),Gynéco-Obstétrique (HTP),0,0,30,30,16,0,0
5/02/2013,Clinique des 3 Frontières,UPATOU (Structure des urgences),0,2,47,49,5,0,1
5/02/2013,Clinique des Diaconesses,SOS Main,0,0,27,27,10,0,0
5/02/2013,Clinique Ste Odile (Strasbourg,UPATOU,1,4,65,70,2,9,2
5/02/2013,CMCO,GYNECO-OBSTETRIQUE,0,0,0,0,0,0,0
5/02/2013,SIHCUS/CMCO,GYNECOLOGIE ET OBSTETRIQUE - CMCO,0,0,0,0,0,0,0
4/02/2013,CCOM,CCOM Chirurgie,0,1,29,30,1,0,0
4/02/2013,CH Altkirch,Upatou,0,7,39,46,5,2,0
4/02/2013,CH de Colmar (CMC Le Parc),SAU Le Parc,12,0,40,52,9,0,0
4/02/2013,CH de Colmar (Louis Pasteur),SAU Pasteur,0,24,103,127,13,12,0
4/02/2013,CH de Guebwiller,UHTCD,0,3,40,43,2,1,1
4/02/2013,CH de Mulhouse ( Hasenrain),PEDIATRIE NEONATOLOGIE,13,0,37,50,4,2,0
4/02/2013,CH de Mulhouse (Emile Muller-Moenschberg,URGENCES,2,19,121,142,16,9,7
4/02/2013,CH de Saverne,S.A.U. (ADULTES),0,16,44,60,17,3,0
4/02/2013,CH de Saverne,PEDIATRIE,3,0,22,25,6,0,0
4/02/2013,CH de Sélestat,Acceuil des urgences,0,12,72,84,16,6,3
4/02/2013,CH de Thann,Urgences,0,10,31,41,3,2,0
4/02/2013,CH de Wissembourg,Urgences ,1,9,31,41,11,0,0
4/02/2013,CHU de Strasbourg (Hôp. Civil),Urgences Médico-Chirurgicales NHC,0,25,66,91,41,2,2
4/02/2013,CHU de Strasbourg(Hautepierre),Urgences chirurgicales pédiatriques,5,0,64,69,6,5,0
4/02/2013,CHU de Strasbourg(Hautepierre),Urgences Adulte HTP,0,12,79,91,36,0,0
4/02/2013,CHU de Strasbourg(Hautepierre),Urgences chirurgicales pédiatriques,17,0,58,75,11,11,0
4/02/2013,CHU de Strasbourg(Hautepierre),Gynéco-Obstétrique (HTP),0,1,32,33,13,0,0
4/02/2013,Clinique des 3 Frontières,UPATOU (Structure des urgences),0,5,47,52,3,0,3
4/02/2013,Clinique des Diaconesses,SOS Main,0,2,35,37,8,0,0
4/02/2013,Clinique Ste Odile (Strasbourg,UPATOU,0,2,74,76,0,8,4
4/02/2013,CMCO,GYNECO-OBSTETRIQUE,0,0,0,0,0,0,0
4/02/2013,SIHCUS/CMCO,GYNECOLOGIE ET OBSTETRIQUE - CMCO,0,0,0,0,0,0,0
3/02/2013,CCOM,CCOM Chirurgie,0,0,15,15,1,0,0
3/02/2013,CH Altkirch,Upatou,0,4,38,42,4,2,2
3/02/2013,CH de Colmar (CMC Le Parc),SAU Le Parc,9,0,61,70,10,0,0
3/02/2013,CH de Colmar (Louis Pasteur),SAU Pasteur,0,16,100,116,18,15,2
3/02/2013,CH de Guebwiller,UHTCD,0,4,39,43,0,5,1
3/02/2013,CH de Mulhouse ( Hasenrain),PEDIATRIE NEONATOLOGIE,10,0,45,55,9,0,0
3/02/2013,CH de Mulhouse (Emile Muller-Moenschberg,URGENCES,1,24,119,144,10,12,5
3/02/2013,CH de Saverne,S.A.U. (ADULTES),0,8,51,59,8,4,0
3/02/2013,CH de Saverne,PEDIATRIE,4,0,17,21,1,1,0
3/02/2013,CH de Sélestat,Acceuil des urgences,3,9,87,99,12,3,2
3/02/2013,CH de Thann,Urgences,0,9,35,44,4,3,1
3/02/2013,CH de Wissembourg,Urgences ,2,8,22,32,4,3,2
3/02/2013,CHU de Strasbourg (Hôp. Civil),Urgences Médico-Chirurgicales NHC,0,18,76,94,31,0,0
3/02/2013,CHU de Strasbourg(Hautepierre),Urgences chirurgicales pédiatriques,17,0,67,84,9,8,0
3/02/2013,CHU de Strasbourg(Hautepierre),Gynéco-Obstétrique (HTP),0,0,27,27,11,0,0
3/02/2013,CHU de Strasbourg(Hautepierre),Urgences Adulte HTP,0,13,82,95,45,0,0
3/02/2013,CHU de Strasbourg(Hautepierre),Urgences chirurgicales pédiatriques,2,0,45,47,4,4,0
3/02/2013,Clinique des 3 Frontières,UPATOU (Structure des urgences),2,2,53,57,7,0,1
3/02/2013,Clinique des Diaconesses,SOS Main,0,0,28,28,12,0,0
3/02/2013,Clinique Ste Odile (Strasbourg,UPATOU,1,4,81,86,1,6,1
3/02/2013,CMCO,GYNECO-OBSTETRIQUE,0,0,0,0,0,0,0
3/02/2013,SIHCUS/CMCO,GYNECOLOGIE ET OBSTETRIQUE - CMCO,0,0,0,0,0,0,0
2/02/2013,CCOM,CCOM Chirurgie,0,0,16,16,0,0,0
2/02/2013,CH Altkirch,Upatou,0,7,30,37,9,2,0
2/02/2013,CH de Colmar (CMC Le Parc),SAU Le Parc,15,0,58,73,11,0,0
2/02/2013,CH de Colmar (Louis Pasteur),SAU Pasteur,0,32,107,139,24,10,5
2/02/2013,CH de Guebwiller,UHTCD,0,7,28,35,0,2,2
2/02/2013,CH de Mulhouse ( Hasenrain),PEDIATRIE NEONATOLOGIE,18,0,46,64,5,2,0
2/02/2013,CH de Mulhouse (Emile Muller-Moenschberg,URGENCES,0,27,106,133,15,13,3
2/02/2013,CH de Saverne,PEDIATRIE,3,0,13,16,2,1,0
2/02/2013,CH de Saverne,S.A.U. (ADULTES),1,8,47,56,5,1,1
2/02/2013,CH de Sélestat,Acceuil des urgences,1,9,72,82,12,2,1
2/02/2013,CH de Thann,Urgences,0,13,32,45,4,13,1
2/02/2013,CH de Wissembourg,Urgences ,2,6,31,39,8,0,1
2/02/2013,CHU de Strasbourg (Hôp. Civil),Urgences Médico-Chirurgicales NHC,0,19,83,102,40,2,0
2/02/2013,CHU de Strasbourg(Hautepierre),Urgences chirurgicales pédiatriques,20,0,74,94,12,12,0
2/02/2013,CHU de Strasbourg(Hautepierre),Gynéco-Obstétrique (HTP),0,0,27,27,9,0,0
2/02/2013,CHU de Strasbourg(Hautepierre),Urgences Adulte HTP,0,10,63,73,31,0,0
2/02/2013,CHU de Strasbourg(Hautepierre),Urgences chirurgicales pédiatriques,1,0,48,49,6,6,0
2/02/2013,Clinique des 3 Frontières,UPATOU (Structure des urgences),2,8,47,57,7,1,1
2/02/2013,Clinique des Diaconesses,SOS Main,0,2,41,43,19,0,0
2/02/2013,Clinique Ste Odile (Strasbourg,UPATOU,0,2,61,63,0,6,2
2/02/2013,CMCO,GYNECO-OBSTETRIQUE,0,0,0,0,0,0,0
2/02/2013,SIHCUS/CMCO,GYNECOLOGIE ET OBSTETRIQUE - CMCO,0,0,0,0,0,0,0
1/02/2013,CCOM,CCOM Chirurgie,0,0,27,27,3,0,0
1/02/2013,CH Altkirch,Upatou,0,7,44,51,6,0,0
1/02/2013,CH de Colmar (CMC Le Parc),SAU Le Parc,45,0,8,53,9,0,0
1/02/2013,CH de Colmar (Louis Pasteur),SAU Pasteur,0,37,102,139,29,13,4
1/02/2013,CH de Guebwiller,UHTCD,1,7,22,30,3,2,0
1/02/2013,CH de Mulhouse ( Hasenrain),PEDIATRIE NEONATOLOGIE,14,0,32,46,8,0,0
1/02/2013,CH de Mulhouse (Emile Muller-Moenschberg,URGENCES,1,26,101,128,12,16,2
1/02/2013,CH de Saverne,PEDIATRIE,2,0,15,17,0,1,0
1/02/2013,CH de Saverne,S.A.U. (ADULTES),0,8,35,43,9,7,0
1/02/2013,CH de Sélestat,Acceuil des urgences,0,7,77,84,22,7,0
1/02/2013,CH de Thann,Urgences,1,7,31,39,4,0,2
1/02/2013,CH de Wissembourg,Urgences ,1,7,23,31,4,2,1
1/02/2013,CHU de Strasbourg (Hôp. Civil),Urgences Médico-Chirurgicales NHC,0,20,53,73,37,2,2
1/02/2013,CHU de Strasbourg(Hautepierre),Urgences chirurgicales pédiatriques,19,0,44,63,8,6,0
1/02/2013,CHU de Strasbourg(Hautepierre),Gynéco-Obstétrique (HTP),1,0,22,23,12,0,0
1/02/2013,CHU de Strasbourg(Hautepierre),Urgences chirurgicales pédiatriques,5,0,46,51,5,5,0
1/02/2013,CHU de Strasbourg(Hautepierre),Urgences Adulte HTP,0,16,71,87,39,0,0
1/02/2013,Clinique des 3 Frontières,UPATOU (Structure des urgences),0,10,48,58,14,1,1
1/02/2013,Clinique des Diaconesses,SOS Main,0,0,31,31,11,0,0
1/02/2013,Clinique Ste Odile (Strasbourg,UPATOU,0,6,54,60,1,5,2
1/02/2013,CMCO,GYNECO-OBSTETRIQUE,0,0,0,0,0,0,0
1/02/2013,SIHCUS/CMCO,GYNECOLOGIE ET OBSTETRIQUE - CMCO,0,0,0,0,0,0,0
31/01/2013,CCOM,CCOM Chirurgie,0,0,23,23,1,0,0
31/01/2013,CH Altkirch,Upatou,0,2,26,28,1,1,2
31/01/2013,CH de Colmar (CMC Le Parc),SAU Le Parc,6,0,58,64,13,0,0
31/01/2013,CH de Colmar (Louis Pasteur),SAU Pasteur,0,24,82,106,16,15,1
31/01/2013,CH de Guebwiller,UHTCD,0,5,32,37,2,4,2
31/01/2013,CH de Mulhouse ( Hasenrain),PEDIATRIE NEONATOLOGIE,16,0,32,48,5,1,0
31/01/2013,CH de Mulhouse (Emile Muller-Moenschberg,URGENCES,1,23,106,130,11,12,2
31/01/2013,CH de Saverne,S.A.U. (ADULTES),0,12,40,52,11,6,0
31/01/2013,CH de Saverne,PEDIATRIE,2,0,28,30,5,2,0
31/01/2013,CH de Sélestat,Acceuil des urgences,3,17,65,85,21,3,4
31/01/2013,CH de Thann,Urgences,1,8,41,50,4,1,2
31/01/2013,CH de Wissembourg,Urgences ,2,8,28,38,9,2,0
31/01/2013,CHU de Strasbourg (Hôp. Civil),Urgences Médico-Chirurgicales NHC,0,16,67,83,51,4,1
31/01/2013,CHU de Strasbourg(Hautepierre),Urgences chirurgicales pédiatriques,3,0,45,48,5,5,0
31/01/2013,CHU de Strasbourg(Hautepierre),Urgences Adulte HTP,0,17,74,91,31,0,1
31/01/2013,CHU de Strasbourg(Hautepierre),Urgences chirurgicales pédiatriques,17,0,58,75,6,6,0
31/01/2013,CHU de Strasbourg(Hautepierre),Gynéco-Obstétrique (HTP),0,0,22,22,9,0,0
31/01/2013,Clinique des 3 Frontières,UPATOU (Structure des urgences),0,6,47,53,5,0,0
31/01/2013,Clinique des Diaconesses,SOS Main,0,2,35,37,15,0,0
31/01/2013,Clinique Ste Odile (Strasbourg,UPATOU,1,3,67,71,1,8,2
31/01/2013,CMCO,GYNECO-OBSTETRIQUE,0,0,0,0,0,0,0
31/01/2013,SIHCUS/CMCO,GYNECOLOGIE ET OBSTETRIQUE - CMCO,0,0,0,0,0,0,0
30/01/2013,CCOM,CCOM Chirurgie,0,1,26,27,2,0,0
30/01/2013,CH Altkirch,Upatou,2,8,29,39,3,2,2
30/01/2013,CH de Colmar (CMC Le Parc),SAU Le Parc,12,0,37,49,9,0,0
30/01/2013,CH de Colmar (Louis Pasteur),SAU Pasteur,0,24,93,117,22,13,0
30/01/2013,CH de Guebwiller,UHTCD,0,3,31,34,0,1,1
30/01/2013,CH de Mulhouse ( Hasenrain),PEDIATRIE NEONATOLOGIE,15,0,27,42,6,2,0
30/01/2013,CH de Mulhouse (Emile Muller-Moenschberg,URGENCES,1,20,97,118,14,11,4
30/01/2013,CH de Saverne,S.A.U. (ADULTES),0,15,43,58,16,6,3
30/01/2013,CH de Saverne,PEDIATRIE,3,0,16,19,4,1,0
30/01/2013,CH de Sélestat,Acceuil des urgences,0,19,59,78,14,4,4
30/01/2013,CH de Thann,Urgences,0,10,37,47,5,2,1
30/01/2013,CH de Wissembourg,Urgences ,1,1,41,43,8,0,0
30/01/2013,CHU de Strasbourg (Hôp. Civil),Urgences Médico-Chirurgicales NHC,0,11,72,83,49,4,0
30/01/2013,CHU de Strasbourg(Hautepierre),Gynéco-Obstétrique (HTP),0,0,26,26,12,0,0
30/01/2013,CHU de Strasbourg(Hautepierre),Urgences chirurgicales pédiatriques,3,0,38,41,2,2,0
30/01/2013,CHU de Strasbourg(Hautepierre),Urgences Adulte HTP,0,18,71,89,28,0,1
30/01/2013,CHU de Strasbourg(Hautepierre),Urgences chirurgicales pédiatriques,13,0,55,68,7,7,0
30/01/2013,Clinique des 3 Frontières,UPATOU (Structure des urgences),0,5,39,44,6,0,1
30/01/2013,Clinique des Diaconesses,SOS Main,0,2,37,39,15,0,1
30/01/2013,Clinique Ste Odile (Strasbourg,UPATOU,0,4,56,60,1,4,1
30/01/2013,CMCO,GYNECO-OBSTETRIQUE,0,0,0,0,0,0,0
30/01/2013,SIHCUS/CMCO,GYNECOLOGIE ET OBSTETRIQUE - CMCO,0,0,0,0,0,0,0
29/01/2013,CCOM,CCOM Chirurgie,0,0,15,15,0,0,0
29/01/2013,CH Altkirch,Upatou,0,5,39,44,5,3,2
29/01/2013,CH de Colmar (CMC Le Parc),SAU Le Parc,11,0,50,61,8,0,0
29/01/2013,CH de Colmar (Louis Pasteur),SAU Pasteur,0,27,98,125,25,12,0
29/01/2013,CH de Guebwiller,UHTCD,31,0,0,31,1,0,1
29/01/2013,CH de Mulhouse ( Hasenrain),PEDIATRIE NEONATOLOGIE,9,0,24,33,1,2,1
29/01/2013,CH de Mulhouse (Emile Muller-Moenschberg,URGENCES,3,23,112,138,9,14,6
29/01/2013,CH de Saverne,S.A.U. (ADULTES),0,12,31,43,13,8,1
29/01/2013,CH de Saverne,PEDIATRIE,3,0,13,16,5,0,0
29/01/2013,CH de Sélestat,Acceuil des urgences,2,15,56,73,17,4,4
29/01/2013,CH de Thann,Urgences,0,4,24,28,4,1,1
29/01/2013,CH de Wissembourg,Urgences ,0,3,28,31,1,0,0
29/01/2013,CHU de Strasbourg (Hôp. Civil),Urgences Médico-Chirurgicales NHC,0,16,53,69,33,2,0
29/01/2013,CHU de Strasbourg(Hautepierre),Urgences chirurgicales pédiatriques,0,0,51,51,5,5,0
29/01/2013,CHU de Strasbourg(Hautepierre),Urgences chirurgicales pédiatriques,15,0,55,70,8,9,0
29/01/2013,CHU de Strasbourg(Hautepierre),Gynéco-Obstétrique (HTP),1,1,23,25,10,0,0
29/01/2013,CHU de Strasbourg(Hautepierre),Urgences Adulte HTP,0,18,78,96,36,0,1
29/01/2013,Clinique des 3 Frontières,UPATOU (Structure des urgences),0,6,38,44,9,0,1
29/01/2013,Clinique des Diaconesses,SOS Main,0,0,39,39,9,0,0
29/01/2013,Clinique Ste Odile (Strasbourg,UPATOU,0,5,62,67,1,7,1
29/01/2013,CMCO,GYNECO-OBSTETRIQUE,0,0,0,0,0,0,0
29/01/2013,SIHCUS/CMCO,GYNECOLOGIE ET OBSTETRIQUE - CMCO,0,0,0,0,0,0,0
28/01/2013,CCOM,CCOM Chirurgie,0,0,15,15,3,0,0
28/01/2013,CH Altkirch,Upatou,1,7,41,49,4,0,0
28/01/2013,CH de Colmar (CMC Le Parc),SAU Le Parc,13,0,56,69,10,0,0
28/01/2013,CH de Colmar (Louis Pasteur),SAU Pasteur,0,24,108,132,24,13,1
28/01/2013,CH de Guebwiller,UHTCD,0,4,49,53,1,1,0
28/01/2013,CH de Mulhouse ( Hasenrain),PEDIATRIE NEONATOLOGIE,13,0,48,61,4,0,0
28/01/2013,CH de Mulhouse (Emile Muller-Moenschberg,URGENCES,1,23,109,133,16,13,5
28/01/2013,CH de Saverne,S.A.U. (ADULTES),0,11,46,57,11,4,2
28/01/2013,CH de Saverne,PEDIATRIE,4,0,25,29,6,1,0
28/01/2013,CH de Sélestat,Acceuil des urgences,4,15,83,102,15,5,2
28/01/2013,CH de Thann,Urgences,1,2,45,48,2,3,0
28/01/2013,CH de Wissembourg,Urgences ,1,4,22,27,5,2,0
28/01/2013,CHU de Strasbourg (Hôp. Civil),Urgences Médico-Chirurgicales NHC,0,19,70,89,47,0,1
28/01/2013,CHU de Strasbourg(Hautepierre),Urgences chirurgicales pédiatriques,20,0,55,75,14,13,0
28/01/2013,CHU de Strasbourg(Hautepierre),Gynéco-Obstétrique (HTP),0,0,29,29,16,0,0
28/01/2013,CHU de Strasbourg(Hautepierre),Urgences chirurgicales pédiatriques,3,0,48,51,4,4,0
28/01/2013,CHU de Strasbourg(Hautepierre),Urgences Adulte HTP,0,16,86,102,39,0,0
28/01/2013,Clinique des 3 Frontières,UPATOU (Structure des urgences),0,8,43,51,5,0,1
28/01/2013,Clinique des Diaconesses,SOS Main,0,0,41,41,9,6,0
28/01/2013,Clinique Ste Odile (Strasbourg,UPATOU,0,2,68,70,3,15,3
28/01/2013,CMCO,GYNECO-OBSTETRIQUE,0,0,0,0,0,0,0
28/01/2013,SIHCUS/CMCO,GYNECOLOGIE ET OBSTETRIQUE - CMCO,0,0,0,0,0,0,0
27/01/2013,CCOM,CCOM Chirurgie,0,4,13,17,1,0,0
27/01/2013,CH Altkirch,Upatou,0,4,30,34,3,2,1
27/01/2013,CH de Colmar (CMC Le Parc),SAU Le Parc,16,0,51,67,9,0,0
27/01/2013,CH de Colmar (Louis Pasteur),SAU Pasteur,0,21,109,130,26,15,0
27/01/2013,CH de Guebwiller,UHTCD,0,3,31,34,0,4,1
27/01/2013,CH de Mulhouse ( Hasenrain),PEDIATRIE NEONATOLOGIE,16,0,38,54,5,2,0
27/01/2013,CH de Mulhouse (Emile Muller-Moenschberg,URGENCES,1,24,121,146,16,10,2
27/01/2013,CH de Saverne,PEDIATRIE,6,0,17,23,2,0,0
27/01/2013,CH de Saverne,S.A.U. (ADULTES),0,10,44,54,7,7,2
27/01/2013,CH de Sélestat,Acceuil des urgences,0,6,92,98,11,5,1
27/01/2013,CH de Thann,Urgences,0,4,43,47,0,1,2
27/01/2013,CH de Wissembourg,Urgences ,1,7,35,43,5,1,0
27/01/2013,CHU de Strasbourg (Hôp. Civil),Urgences Médico-Chirurgicales NHC,0,18,72,90,40,0,2
27/01/2013,CHU de Strasbourg(Hautepierre),Urgences Adulte HTP,0,22,86,108,32,0,2
27/01/2013,CHU de Strasbourg(Hautepierre),Urgences chirurgicales pédiatriques,3,0,46,49,3,3,0
27/01/2013,CHU de Strasbourg(Hautepierre),Urgences chirurgicales pédiatriques,21,0,57,78,6,6,0
27/01/2013,CHU de Strasbourg(Hautepierre),Gynéco-Obstétrique (HTP),0,0,42,42,13,0,0
27/01/2013,Clinique des 3 Frontières,UPATOU (Structure des urgences),0,1,39,40,6,0,1
27/01/2013,Clinique des Diaconesses,SOS Main,0,1,28,29,12,0,1
27/01/2013,Clinique Ste Odile (Strasbourg,UPATOU,0,2,84,86,0,6,2
27/01/2013,CMCO,GYNECO-OBSTETRIQUE,0,0,0,0,0,0,0
27/01/2013,SIHCUS/CMCO,GYNECOLOGIE ET OBSTETRIQUE - CMCO,0,0,0,0,0,0,0
26/01/2013,CCOM,CCOM Chirurgie,0,3,24,27,8,0,0
26/01/2013,CH de Colmar (CMC Le Parc),SAU Le Parc,10,0,51,61,10,0,0
26/01/2013,CH de Colmar (Louis Pasteur),SAU Pasteur,0,18,104,122,22,4,7
26/01/2013,CH de Guebwiller,UHTCD,0,4,27,31,0,3,1
26/01/2013,CH de Mulhouse ( Hasenrain),PEDIATRIE NEONATOLOGIE,12,0,25,37,9,1,0
26/01/2013,CH de Mulhouse (Emile Muller-Moenschberg,URGENCES,2,20,109,131,12,11,3
26/01/2013,CH de Saverne,PEDIATRIE,3,0,19,22,1,0,0
26/01/2013,CH de Saverne,S.A.U. (ADULTES),0,10,56,66,12,2,1
26/01/2013,CH de Sélestat,Acceuil des urgences,1,9,77,87,14,7,4
26/01/2013,CH de Thann,Urgences,0,9,40,49,4,2,6
26/01/2013,CH de Wissembourg,Urgences ,0,3,24,27,4,0,1
26/01/2013,CHU de Strasbourg (Hôp. Civil),Urgences Médico-Chirurgicales NHC,0,27,84,111,61,0,1
26/01/2013,CHU de Strasbourg(Hautepierre),Urgences chirurgicales pédiatriques,13,0,58,71,6,6,0
26/01/2013,CHU de Strasbourg(Hautepierre),Gynéco-Obstétrique (HTP),1,0,35,36,11,0,0
26/01/2013,CHU de Strasbourg(Hautepierre),Urgences Adulte HTP,0,21,83,104,32,0,0
26/01/2013,CHU de Strasbourg(Hautepierre),Urgences chirurgicales pédiatriques,3,0,41,44,4,4,0
26/01/2013,Clinique des 3 Frontières,UPATOU (Structure des urgences),1,5,45,51,8,0,1
26/01/2013,Clinique des Diaconesses,SOS Main,0,2,23,25,7,1,0
26/01/2013,Clinique Ste Odile (Strasbourg,UPATOU,1,9,70,80,2,8,2
26/01/2013,CMCO,GYNECO-OBSTETRIQUE,0,0,0,0,0,0,0
26/01/2013,SIHCUS/CMCO,GYNECOLOGIE ET OBSTETRIQUE - CMCO,0,0,0,0,0,0,0
25/01/2013,CCOM,CCOM Chirurgie,0,1,17,18,0,0,0
25/01/2013,CH Altkirch,Upatou,0,1,32,33,6,1,1
25/01/2013,CH de Colmar (CMC Le Parc),SAU Le Parc,9,0,49,58,6,0,0
25/01/2013,CH de Colmar (Louis Pasteur),SAU Pasteur,0,24,99,123,29,9,2
25/01/2013,CH de Guebwiller,UHTCD,0,6,39,45,1,2,0
25/01/2013,CH de Mulhouse ( Hasenrain),PEDIATRIE NEONATOLOGIE,13,0,31,44,4,2,0
25/01/2013,CH de Mulhouse (Emile Muller-Moenschberg,URGENCES,2,21,93,116,9,15,3
25/01/2013,CH de Saverne,PEDIATRIE,9,0,20,29,4,1,0
25/01/2013,CH de Saverne,S.A.U. (ADULTES),0,10,47,57,12,3,0
25/01/2013,CH de Sélestat,Acceuil des urgences,1,15,61,77,13,4,1
25/01/2013,CH de Thann,Urgences,0,5,38,43,4,2,3
25/01/2013,CH de Wissembourg,Urgences ,0,9,14,23,7,0,0
25/01/2013,CHU de Strasbourg (Hôp. Civil),Urgences Médico-Chirurgicales NHC,0,20,64,84,48,3,2
25/01/2013,CHU de Strasbourg(Hautepierre),Urgences chirurgicales pédiatriques,3,0,57,60,8,8,0
25/01/2013,CHU de Strasbourg(Hautepierre),Urgences Adulte HTP,0,23,75,98,43,0,0
25/01/2013,CHU de Strasbourg(Hautepierre),Urgences chirurgicales pédiatriques,15,0,40,55,9,8,0
25/01/2013,CHU de Strasbourg(Hautepierre),Gynéco-Obstétrique (HTP),0,0,20,20,8,0,0
25/01/2013,Clinique des 3 Frontières,UPATOU (Structure des urgences),0,9,41,50,7,0,0
25/01/2013,Clinique des Diaconesses,SOS Main,0,3,25,28,4,1,0
25/01/2013,Clinique Ste Odile (Strasbourg,UPATOU,0,5,55,60,0,4,1
25/01/2013,CMCO,GYNECO-OBSTETRIQUE,0,0,0,0,0,0,0
25/01/2013,SIHCUS/CMCO,GYNECOLOGIE ET OBSTETRIQUE - CMCO,0,0,0,0,0,0,0
24/01/2013,CCOM,CCOM Chirurgie,0,1,24,25,2,0,0
24/01/2013,CH Altkirch,Upatou,0,6,42,48,6,3,1
24/01/2013,CH de Colmar (CMC Le Parc),SAU Le Parc,9,0,58,67,9,0,0
24/01/2013,CH de Colmar (Louis Pasteur),SAU Pasteur,0,30,100,130,22,14,1
24/01/2013,CH de Guebwiller,UHTCD,0,7,39,46,1,5,1
24/01/2013,CH de Mulhouse ( Hasenrain),PEDIATRIE NEONATOLOGIE,8,0,33,41,4,1,0
24/01/2013,CH de Mulhouse (Emile Muller-Moenschberg,URGENCES,0,24,128,152,15,13,7
24/01/2013,CH de Saverne,S.A.U. (ADULTES),0,13,37,50,13,4,3
24/01/2013,CH de Saverne,PEDIATRIE,1,0,16,17,1,1,0
24/01/2013,CH de Sélestat,Acceuil des urgences,1,15,66,82,14,3,3
24/01/2013,CH de Thann,Urgences,0,10,25,35,5,1,0
24/01/2013,CH de Wissembourg,Urgences ,0,3,28,31,5,0,1
24/01/2013,CHU de Strasbourg (Hôp. Civil),Urgences Médico-Chirurgicales NHC,0,21,54,75,44,4,0
24/01/2013,CHU de Strasbourg(Hautepierre),Urgences chirurgicales pédiatriques,26,0,43,69,7,7,0
24/01/2013,CHU de Strasbourg(Hautepierre),Gynéco-Obstétrique (HTP),0,0,21,21,12,0,0
24/01/2013,CHU de Strasbourg(Hautepierre),Urgences Adulte HTP,0,12,75,87,32,0,0
24/01/2013,CHU de Strasbourg(Hautepierre),Urgences chirurgicales pédiatriques,2,0,59,61,6,6,0
24/01/2013,Clinique des 3 Frontières,UPATOU (Structure des urgences),0,5,49,54,10,0,0
24/01/2013,Clinique des Diaconesses,SOS Main,0,1,28,29,11,0,0
24/01/2013,Clinique Ste Odile (Strasbourg,UPATOU,0,4,74,78,1,6,0
24/01/2013,CMCO,GYNECO-OBSTETRIQUE,0,0,0,0,0,0,0
24/01/2013,SIHCUS/CMCO,GYNECOLOGIE ET OBSTETRIQUE - CMCO,0,0,0,0,0,0,0
23/01/2013,CCOM,CCOM Chirurgie,0,1,27,28,2,0,0
23/01/2013,CH Altkirch,Upatou,0,12,34,46,6,0,4
23/01/2013,CH de Colmar (CMC Le Parc),SAU Le Parc,8,0,34,42,9,0,0
23/01/2013,CH de Colmar (Louis Pasteur),SAU Pasteur,0,30,94,124,24,17,0
23/01/2013,CH de Guebwiller,UHTCD,0,4,33,37,1,2,1
23/01/2013,CH de Mulhouse ( Hasenrain),PEDIATRIE NEONATOLOGIE,10,0,26,36,5,1,1
23/01/2013,CH de Mulhouse (Emile Muller-Moenschberg,URGENCES,1,15,119,135,10,9,3
23/01/2013,CH de Saverne,PEDIATRIE,4,0,16,20,2,2,0
23/01/2013,CH de Saverne,S.A.U. (ADULTES),0,8,47,55,4,6,2
23/01/2013,CH de Sélestat,Acceuil des urgences,1,14,55,70,17,2,1
23/01/2013,CH de Thann,Urgences,1,7,35,43,9,2,0
23/01/2013,CH de Wissembourg,Urgences ,1,8,21,30,6,0,0
23/01/2013,CHU de Strasbourg (Hôp. Civil),Urgences Médico-Chirurgicales NHC,0,24,65,89,45,3,0
23/01/2013,CHU de Strasbourg(Hautepierre),Urgences chirurgicales pédiatriques,2,0,39,41,4,4,0
23/01/2013,CHU de Strasbourg(Hautepierre),Urgences Adulte HTP,0,18,85,103,43,0,0
23/01/2013,CHU de Strasbourg(Hautepierre),Urgences chirurgicales pédiatriques,14,0,59,73,10,10,0
23/01/2013,CHU de Strasbourg(Hautepierre),Gynéco-Obstétrique (HTP),0,0,20,20,10,0,0
23/01/2013,Clinique des 3 Frontières,UPATOU (Structure des urgences),0,6,40,46,7,0,1
23/01/2013,Clinique des Diaconesses,SOS Main,0,0,38,38,5,0,0
23/01/2013,Clinique Ste Odile (Strasbourg,UPATOU,0,4,67,71,2,7,3
23/01/2013,CMCO,GYNECO-OBSTETRIQUE,0,0,0,0,0,0,0
23/01/2013,SIHCUS/CMCO,GYNECOLOGIE ET OBSTETRIQUE - CMCO,0,0,0,0,0,0,0
22/01/2013,CCOM,CCOM Chirurgie,0,4,30,34,4,0,0
22/01/2013,CH Altkirch,Upatou,0,7,29,36,7,3,1
22/01/2013,CH de Colmar (CMC Le Parc),SAU Le Parc,8,0,40,48,10,0,0
22/01/2013,CH de Colmar (Louis Pasteur),SAU Pasteur,0,23,118,141,29,10,1
22/01/2013,CH de Guebwiller,UHTCD,0,6,34,40,1,3,0
22/01/2013,CH de Mulhouse ( Hasenrain),PEDIATRIE NEONATOLOGIE,13,0,26,39,6,2,1
22/01/2013,CH de Mulhouse (Emile Muller-Moenschberg,URGENCES,0,36,104,140,14,13,8
22/01/2013,CH de Saverne,S.A.U. (ADULTES),0,12,60,72,9,9,0
22/01/2013,CH de Saverne,PEDIATRIE,8,0,17,25,4,0,0
22/01/2013,CH de Sélestat,Acceuil des urgences,0,9,53,62,13,5,1
22/01/2013,CH de Thann,Urgences,0,3,33,36,2,0,2
22/01/2013,CH de Wissembourg,Urgences ,0,6,28,34,6,2,0
22/01/2013,CHU de Strasbourg (Hôp. Civil),Urgences Médico-Chirurgicales NHC,0,13,58,71,36,1,0
22/01/2013,CHU de Strasbourg(Hautepierre),Urgences chirurgicales pédiatriques,1,0,44,45,5,6,0
22/01/2013,CHU de Strasbourg(Hautepierre),Urgences Adulte HTP,1,28,88,117,47,0,0
22/01/2013,CHU de Strasbourg(Hautepierre),Urgences chirurgicales pédiatriques,12,0,46,58,7,7,0
22/01/2013,CHU de Strasbourg(Hautepierre),Gynéco-Obstétrique (HTP),1,0,26,27,12,0,0
22/01/2013,Clinique des 3 Frontières,UPATOU (Structure des urgences),1,3,50,54,4,0,0
22/01/2013,Clinique des Diaconesses,SOS Main,0,1,36,37,5,0,0
22/01/2013,Clinique Ste Odile (Strasbourg,UPATOU,0,6,61,67,3,8,1
22/01/2013,CMCO,GYNECO-OBSTETRIQUE,0,0,0,0,0,0,0
22/01/2013,SIHCUS/CMCO,GYNECOLOGIE ET OBSTETRIQUE - CMCO,0,0,0,0,0,0,0
21/01/2013,CCOM,CCOM Chirurgie,0,3,56,59,5,0,0
21/01/2013,CH Altkirch,Upatou,0,6,38,44,7,1,5
21/01/2013,CH de Colmar (CMC Le Parc),SAU Le Parc,11,0,40,51,14,0,0
21/01/2013,CH de Colmar (Louis Pasteur),SAU Pasteur,0,30,91,121,20,15,0
21/01/2013,CH de Guebwiller,UHTCD,1,6,46,53,1,1,1
21/01/2013,CH de Mulhouse ( Hasenrain),PEDIATRIE NEONATOLOGIE,18,0,29,47,2,3,0
21/01/2013,CH de Mulhouse (Emile Muller-Moenschberg,URGENCES,1,22,105,128,16,7,6
21/01/2013,CH de Saverne,PEDIATRIE,6,0,17,23,3,1,0
21/01/2013,CH de Saverne,S.A.U. (ADULTES),0,15,81,96,13,6,0
21/01/2013,CH de Sélestat,Acceuil des urgences,1,16,69,86,19,5,0
21/01/2013,CH de Thann,Urgences,0,7,31,38,2,2,1
21/01/2013,CH de Wissembourg,Urgences ,1,9,46,56,13,1,2
21/01/2013,CHU de Strasbourg (Hôp. Civil),Urgences Médico-Chirurgicales NHC,0,21,41,62,38,0,0
21/01/2013,CHU de Strasbourg(Hautepierre),Urgences chirurgicales pédiatriques,4,0,45,49,3,3,0
21/01/2013,CHU de Strasbourg(Hautepierre),Urgences Adulte HTP,0,21,95,116,43,0,0
21/01/2013,CHU de Strasbourg(Hautepierre),Urgences chirurgicales pédiatriques,10,0,44,54,7,6,0
21/01/2013,CHU de Strasbourg(Hautepierre),Gynéco-Obstétrique (HTP),0,0,26,26,14,0,0
21/01/2013,Clinique des 3 Frontières,UPATOU (Structure des urgences),0,4,41,45,6,0,1
21/01/2013,Clinique des Diaconesses,SOS Main,0,1,45,46,13,0,0
21/01/2013,Clinique Ste Odile (Strasbourg,UPATOU,0,7,74,81,1,6,1
21/01/2013,CMCO,GYNECO-OBSTETRIQUE,0,0,0,0,0,0,0
21/01/2013,SIHCUS/CMCO,GYNECOLOGIE ET OBSTETRIQUE - CMCO,0,0,0,0,0,0,0
20/01/2013,CCOM,CCOM Chirurgie,0,0,21,21,0,0,0
20/01/2013,CH Altkirch,Upatou,0,9,30,39,8,2,1
20/01/2013,CH de Colmar (CMC Le Parc),SAU Le Parc,9,0,37,46,8,0,0
20/01/2013,CH de Colmar (Louis Pasteur),SAU Pasteur,0,17,104,121,25,11,0
20/01/2013,CH de Guebwiller,UHTCD,0,2,44,46,3,0,4
20/01/2013,CH de Mulhouse ( Hasenrain),PEDIATRIE NEONATOLOGIE,15,0,29,44,10,1,0
20/01/2013,CH de Mulhouse (Emile Muller-Moenschberg,URGENCES,2,20,110,132,19,13,3
20/01/2013,CH de Saverne,PEDIATRIE,1,0,12,13,4,1,0
20/01/2013,CH de Saverne,S.A.U. (ADULTES),0,4,59,63,10,3,1
20/01/2013,CH de Sélestat,Acceuil des urgences,2,12,79,93,12,7,1
20/01/2013,CH de Thann,Urgences,0,10,38,48,4,1,2
20/01/2013,CH de Wissembourg,Urgences ,1,5,35,41,6,3,0
20/01/2013,CHU de Strasbourg (Hôp. Civil),Urgences Médico-Chirurgicales NHC,0,27,67,94,41,0,0
20/01/2013,CHU de Strasbourg(Hautepierre),Urgences chirurgicales pédiatriques,4,0,43,47,5,5,0
20/01/2013,CHU de Strasbourg(Hautepierre),Urgences chirurgicales pédiatriques,18,0,53,71,10,10,0
20/01/2013,CHU de Strasbourg(Hautepierre),Gynéco-Obstétrique (HTP),0,0,15,15,5,0,0
20/01/2013,CHU de Strasbourg(Hautepierre),Urgences Adulte HTP,0,17,129,146,52,0,1
20/01/2013,Clinique des 3 Frontières,UPATOU (Structure des urgences),1,4,36,41,4,0,0
20/01/2013,Clinique des Diaconesses,SOS Main,0,6,33,39,12,3,0
20/01/2013,Clinique Ste Odile (Strasbourg,UPATOU,1,8,82,91,3,9,2
20/01/2013,CMCO,GYNECO-OBSTETRIQUE,0,0,0,0,0,0,0
20/01/2013,SIHCUS/CMCO,GYNECOLOGIE ET OBSTETRIQUE - CMCO,0,0,0,0,0,0,0
19/01/2013,CCOM,CCOM Chirurgie,0,0,14,14,3,0,0
19/01/2013,CH Altkirch,Upatou,1,5,22,28,3,0,0
19/01/2013,CH de Colmar (CMC Le Parc),SAU Le Parc,7,0,29,36,5,0,0
19/01/2013,CH de Colmar (Louis Pasteur),SAU Pasteur,0,23,103,126,19,12,3
19/01/2013,CH de Guebwiller,UHTCD,1,1,35,37,0,0,2
19/01/2013,CH de Mulhouse ( Hasenrain),PEDIATRIE NEONATOLOGIE,15,0,30,45,9,0,0
19/01/2013,CH de Mulhouse (Emile Muller-Moenschberg,URGENCES,2,23,111,136,18,10,3
19/01/2013,CH de Saverne,S.A.U. (ADULTES),0,9,44,53,12,5,1
19/01/2013,CH de Saverne,PEDIATRIE,3,0,13,16,3,0,0
19/01/2013,CH de Sélestat,Acceuil des urgences,2,13,73,88,15,5,0
19/01/2013,CH de Thann,Urgences,1,5,44,50,6,1,5
19/01/2013,CH de Wissembourg,Urgences ,1,4,21,26,4,0,0
19/01/2013,CHU de Strasbourg (Hôp. Civil),Urgences Médico-Chirurgicales NHC,0,16,62,78,34,8,0
19/01/2013,CHU de Strasbourg(Hautepierre),Urgences chirurgicales pédiatriques,15,0,59,74,11,10,0
19/01/2013,CHU de Strasbourg(Hautepierre),Gynéco-Obstétrique (HTP),0,1,27,28,7,0,0
19/01/2013,CHU de Strasbourg(Hautepierre),Urgences Adulte HTP,0,20,62,82,31,0,0
19/01/2013,CHU de Strasbourg(Hautepierre),Urgences chirurgicales pédiatriques,1,0,45,46,7,7,0
19/01/2013,Clinique des 3 Frontières,UPATOU (Structure des urgences),0,4,45,49,4,0,1
19/01/2013,Clinique des Diaconesses,SOS Main,0,1,31,32,2,0,0
19/01/2013,Clinique Ste Odile (Strasbourg,UPATOU,0,4,54,58,2,8,5
19/01/2013,CMCO,GYNECO-OBSTETRIQUE,0,0,0,0,0,0,0
19/01/2013,SIHCUS/CMCO,GYNECOLOGIE ET OBSTETRIQUE - CMCO,0,0,0,0,0,0,0
18/01/2013,CCOM,CCOM Chirurgie,0,0,29,29,3,0,0
18/01/2013,CH Altkirch,Upatou,0,7,29,36,6,1,2
18/01/2013,CH de Colmar (CMC Le Parc),SAU Le Parc,3,0,47,50,7,1,1
18/01/2013,CH de Colmar (Louis Pasteur),SAU Pasteur,0,24,123,147,24,13,3
18/01/2013,CH de Guebwiller,UHTCD,0,7,26,33,2,1,2
18/01/2013,CH de Mulhouse ( Hasenrain),PEDIATRIE NEONATOLOGIE,8,0,23,31,6,2,0
18/01/2013,CH de Mulhouse (Emile Muller-Moenschberg,URGENCES,0,16,104,120,18,8,3
18/01/2013,CH de Saverne,S.A.U. (ADULTES),0,10,44,54,7,2,0
18/01/2013,CH de Saverne,PEDIATRIE,5,0,22,27,4,0,0
18/01/2013,CH de Sélestat,Acceuil des urgences,2,19,57,78,15,2,3
18/01/2013,CH de Wissembourg,Urgences ,0,2,23,25,4,0,1
18/01/2013,CHU de Strasbourg (Hôp. Civil),Urgences Médico-Chirurgicales NHC,0,20,55,75,43,6,1
18/01/2013,CHU de Strasbourg(Hautepierre),Urgences chirurgicales pédiatriques,2,0,45,47,6,6,0
18/01/2013,CHU de Strasbourg(Hautepierre),Urgences Adulte HTP,0,16,77,93,32,0,0
18/01/2013,CHU de Strasbourg(Hautepierre),Urgences chirurgicales pédiatriques,14,0,51,65,10,7,0
18/01/2013,CHU de Strasbourg(Hautepierre),Gynéco-Obstétrique (HTP),0,1,30,31,12,0,0
18/01/2013,Clinique des 3 Frontières,UPATOU (Structure des urgences),0,6,38,44,6,0,2
18/01/2013,Clinique des Diaconesses,SOS Main,1,2,35,38,2,0,0
18/01/2013,Clinique Ste Odile (Strasbourg,UPATOU,0,6,65,71,5,7,0
18/01/2013,CMCO,GYNECO-OBSTETRIQUE,0,0,0,0,0,0,0
18/01/2013,SIHCUS/CMCO,GYNECOLOGIE ET OBSTETRIQUE - CMCO,0,0,0,0,0,0,0
17/01/2013,CCOM,CCOM Chirurgie,0,2,10,12,1,0,0
17/01/2013,CH Altkirch,Upatou,1,4,23,28,2,0,1
17/01/2013,CH de Colmar (CMC Le Parc),SAU Le Parc,6,0,36,42,4,0,0
17/01/2013,CH de Colmar (Louis Pasteur),SAU Pasteur,0,28,112,140,23,12,0
17/01/2013,CH de Guebwiller,UHTCD,1,5,32,38,0,3,3
17/01/2013,CH de Mulhouse ( Hasenrain),PEDIATRIE NEONATOLOGIE,8,0,24,32,5,3,0
17/01/2013,CH de Mulhouse (Emile Muller-Moenschberg,URGENCES,0,25,98,123,14,11,6
17/01/2013,CH de Saverne,S.A.U. (ADULTES),0,15,29,44,7,6,1
17/01/2013,CH de Saverne,PEDIATRIE,8,0,11,19,3,0,0
17/01/2013,CH de Sélestat,Acceuil des urgences,1,13,57,71,12,7,1
17/01/2013,CH de Thann,Urgences,0,6,26,32,4,0,0
17/01/2013,CHU de Strasbourg (Hôp. Civil),Urgences Médico-Chirurgicales NHC,0,19,50,69,38,0,1
17/01/2013,CHU de Strasbourg(Hautepierre),Urgences chirurgicales pédiatriques,14,0,42,56,6,6,0
17/01/2013,CHU de Strasbourg(Hautepierre),Gynéco-Obstétrique (HTP),0,0,26,26,13,0,0
17/01/2013,CHU de Strasbourg(Hautepierre),Urgences Adulte HTP,0,22,67,89,38,0,1
17/01/2013,CHU de Strasbourg(Hautepierre),Urgences chirurgicales pédiatriques,2,0,42,44,3,3,0
17/01/2013,Clinique des 3 Frontières,UPATOU (Structure des urgences),0,6,37,43,3,0,1
17/01/2013,Clinique Ste Odile (Strasbourg,UPATOU,0,2,52,54,1,5,1
17/01/2013,CMCO,GYNECO-OBSTETRIQUE,0,0,0,0,0,0,0
17/01/2013,SIHCUS/CMCO,GYNECOLOGIE ET OBSTETRIQUE - CMCO,0,0,0,0,0,0,0
16/01/2013,CCOM,CCOM Chirurgie,0,0,18,18,2,0,0
16/01/2013,CH Altkirch,Upatou,1,1,30,32,2,0,1
16/01/2013,CH de Colmar (CMC Le Parc),SAU Le Parc,11,0,31,42,6,0,0
16/01/2013,CH de Colmar (Louis Pasteur),SAU Pasteur,0,15,95,110,10,9,0
16/01/2013,CH de Guebwiller,UHTCD,1,1,26,28,0,3,1
16/01/2013,CH de Mulhouse ( Hasenrain),PEDIATRIE NEONATOLOGIE,14,0,23,37,5,2,0
16/01/2013,CH de Mulhouse (Emile Muller-Moenschberg,URGENCES,0,21,93,114,16,9,5
16/01/2013,CH de Saverne,PEDIATRIE,1,0,17,18,3,0,0
16/01/2013,CH de Saverne,S.A.U. (ADULTES),0,12,37,49,13,3,0
16/01/2013,CH de Sélestat,Acceuil des urgences,2,10,51,63,12,6,1
16/01/2013,CH de Thann,Urgences,1,4,37,42,2,0,0
16/01/2013,CHU de Strasbourg (Hôp. Civil),Urgences Médico-Chirurgicales NHC,0,18,63,81,52,0,1
16/01/2013,CHU de Strasbourg(Hautepierre),Urgences chirurgicales pédiatriques,3,0,33,36,6,6,0
16/01/2013,CHU de Strasbourg(Hautepierre),Urgences chirurgicales pédiatriques,15,0,35,50,7,7,0
16/01/2013,CHU de Strasbourg(Hautepierre),Urgences Adulte HTP,0,22,77,99,35,0,1
16/01/2013,CHU de Strasbourg(Hautepierre),Gynéco-Obstétrique (HTP),0,0,22,22,12,0,0
16/01/2013,Clinique des 3 Frontières,UPATOU (Structure des urgences),2,4,44,50,3,0,0
16/01/2013,Clinique Ste Odile (Strasbourg,UPATOU,0,1,56,57,2,5,0
16/01/2013,CMCO,GYNECO-OBSTETRIQUE,0,0,0,0,0,0,0
16/01/2013,SIHCUS/CMCO,GYNECOLOGIE ET OBSTETRIQUE - CMCO,0,0,0,0,0,0,0
15/01/2013,CCOM,CCOM Chirurgie,0,0,21,21,2,0,0
15/01/2013,CH Altkirch,Upatou,0,5,33,38,4,5,0
15/01/2013,CH de Colmar (CMC Le Parc),SAU Le Parc,7,0,31,38,9,0,0
15/01/2013,CH de Colmar (Louis Pasteur),SAU Pasteur,0,22,85,107,23,14,0
15/01/2013,CH de Guebwiller,UHTCD,0,5,42,47,1,1,1
15/01/2013,CH de Mulhouse ( Hasenrain),PEDIATRIE NEONATOLOGIE,13,0,23,36,7,0,0
15/01/2013,CH de Mulhouse (Emile Muller-Moenschberg,URGENCES,0,19,104,123,15,16,7
15/01/2013,CH de Saverne,S.A.U. (ADULTES),0,11,37,48,17,5,1
15/01/2013,CH de Saverne,PEDIATRIE,2,0,7,9,0,0,0
15/01/2013,CH de Sélestat,Acceuil des urgences,2,9,78,89,6,4,1
15/01/2013,CH de Thann,Urgences,0,6,30,36,5,3,0
15/01/2013,CHU de Strasbourg (Hôp. Civil),Urgences Médico-Chirurgicales NHC,0,17,58,75,42,2,1
15/01/2013,CHU de Strasbourg(Hautepierre),Urgences chirurgicales pédiatriques,0,0,33,33,6,6,0
15/01/2013,CHU de Strasbourg(Hautepierre),Urgences chirurgicales pédiatriques,14,0,33,47,9,9,0
15/01/2013,CHU de Strasbourg(Hautepierre),Gynéco-Obstétrique (HTP),0,0,25,25,8,0,0
15/01/2013,CHU de Strasbourg(Hautepierre),Urgences Adulte HTP,0,18,82,100,48,0,1
15/01/2013,Clinique des 3 Frontières,UPATOU (Structure des urgences),1,7,31,39,3,1,1
15/01/2013,Clinique Ste Odile (Strasbourg,UPATOU,0,1,48,49,0,3,0
15/01/2013,CMCO,GYNECO-OBSTETRIQUE,0,0,0,0,0,0,0
15/01/2013,SIHCUS/CMCO,GYNECOLOGIE ET OBSTETRIQUE - CMCO,0,0,0,0,0,0,0
14/01/2013,CCOM,CCOM Chirurgie,0,2,28,30,4,0,0
14/01/2013,CH Altkirch,Upatou,0,5,41,46,4,1,3
14/01/2013,CH de Colmar (CMC Le Parc),SAU Le Parc,2,0,35,37,7,1,0
14/01/2013,CH de Colmar (Louis Pasteur),SAU Pasteur,1,23,100,124,23,11,0
14/01/2013,CH de Guebwiller,UHTCD,1,6,39,46,0,3,6
14/01/2013,CH de Mulhouse ( Hasenrain),PEDIATRIE NEONATOLOGIE,14,0,23,37,6,0,0
14/01/2013,CH de Mulhouse (Emile Muller-Moenschberg,URGENCES,2,15,113,130,15,7,6
14/01/2013,CH de Saverne,S.A.U. (ADULTES),0,14,43,57,16,5,1
14/01/2013,CH de Saverne,PEDIATRIE,8,0,12,20,5,0,0
14/01/2013,CH de Sélestat,Acceuil des urgences,0,10,54,64,14,4,0
14/01/2013,CH de Thann,Urgences,0,5,41,46,5,3,0
14/01/2013,CHU de Strasbourg (Hôp. Civil),Urgences Médico-Chirurgicales NHC,0,29,54,83,52,7,0
14/01/2013,CHU de Strasbourg(Hautepierre),Urgences chirurgicales pédiatriques,10,0,54,64,8,7,0
14/01/2013,CHU de Strasbourg(Hautepierre),Gynéco-Obstétrique (HTP),1,0,44,45,17,0,0
14/01/2013,CHU de Strasbourg(Hautepierre),Urgences chirurgicales pédiatriques,2,0,38,40,7,6,0
14/01/2013,CHU de Strasbourg(Hautepierre),Urgences Adulte HTP,0,25,84,109,50,0,0
14/01/2013,Clinique des 3 Frontières,UPATOU (Structure des urgences),0,1,36,37,5,1,0
14/01/2013,Clinique des Diaconesses,SOS Main,0,3,47,50,10,2,0
14/01/2013,Clinique Ste Odile (Strasbourg,UPATOU,0,4,59,63,2,4,2
14/01/2013,CMCO,GYNECO-OBSTETRIQUE,0,0,0,0,0,0,0
14/01/2013,SIHCUS/CMCO,GYNECOLOGIE ET OBSTETRIQUE - CMCO,0,0,0,0,0,0,0
13/01/2013,CCOM,CCOM Chirurgie,0,1,13,14,3,0,0
13/01/2013,CH Altkirch,Upatou,0,5,41,46,4,2,5
13/01/2013,CH de Colmar (CMC Le Parc),SAU Le Parc,8,0,45,53,9,0,0
13/01/2013,CH de Colmar (Louis Pasteur),SAU Pasteur,0,16,78,94,10,13,0
13/01/2013,CH de Guebwiller,UHTCD,0,3,41,44,2,5,7
13/01/2013,CH de Mulhouse ( Hasenrain),PEDIATRIE NEONATOLOGIE,14,0,27,41,5,0,0
13/01/2013,CH de Mulhouse (Emile Muller-Moenschberg,URGENCES,2,22,113,137,18,9,3
13/01/2013,CH de Saverne,S.A.U. (ADULTES),0,8,37,45,7,2,0
13/01/2013,CH de Saverne,PEDIATRIE,9,0,22,31,1,0,0
13/01/2013,CH de Sélestat,Acceuil des urgences,1,7,67,75,13,5,0
13/01/2013,CH de Thann,Urgences,0,3,26,29,0,0,2
13/01/2013,CH de Wissembourg,Urgences ,2,7,20,29,6,0,1
13/01/2013,CHU de Strasbourg (Hôp. Civil),Urgences Médico-Chirurgicales NHC,0,13,81,94,28,0,1
13/01/2013,CHU de Strasbourg(Hautepierre),Urgences chirurgicales pédiatriques,25,0,60,85,3,3,0
13/01/2013,CHU de Strasbourg(Hautepierre),Gynéco-Obstétrique (HTP),0,0,27,27,4,0,0
13/01/2013,CHU de Strasbourg(Hautepierre),Urgences chirurgicales pédiatriques,2,0,44,46,3,3,0
13/01/2013,CHU de Strasbourg(Hautepierre),Urgences Adulte HTP,0,15,64,79,24,0,0
13/01/2013,Clinique des 3 Frontières,UPATOU (Structure des urgences),2,5,47,54,2,0,3
13/01/2013,Clinique Ste Odile (Strasbourg,UPATOU,0,1,66,67,1,6,3
13/01/2013,CMCO,GYNECO-OBSTETRIQUE,0,0,0,0,0,0,0
13/01/2013,SIHCUS/CMCO,GYNECOLOGIE ET OBSTETRIQUE - CMCO,0,0,0,0,0,0,0
12/01/2013,CCOM,CCOM Chirurgie,0,0,13,13,0,0,0
12/01/2013,CH Altkirch,Upatou,0,5,26,31,2,1,1
12/01/2013,CH de Colmar (CMC Le Parc),SAU Le Parc,11,0,35,46,11,0,0
12/01/2013,CH de Colmar (Louis Pasteur),SAU Pasteur,0,18,98,116,19,10,2
12/01/2013,CH de Guebwiller,UHTCD,0,4,29,33,0,2,0
12/01/2013,CH de Mulhouse ( Hasenrain),PEDIATRIE NEONATOLOGIE,18,0,26,44,3,1,0
12/01/2013,CH de Mulhouse (Emile Muller-Moenschberg,URGENCES,1,19,105,125,15,11,7
12/01/2013,CH de Saverne,PEDIATRIE,3,0,18,21,2,2,0
12/01/2013,CH de Saverne,S.A.U. (ADULTES),0,11,39,50,12,2,0
12/01/2013,CH de Sélestat,Acceuil des urgences,1,12,51,64,12,5,0
12/01/2013,CH de Thann,Urgences,0,5,30,35,0,0,2
12/01/2013,CH de Wissembourg,Urgences ,1,7,21,29,7,3,1
12/01/2013,CHU de Strasbourg (Hôp. Civil),Urgences Médico-Chirurgicales NHC,0,22,81,103,44,2,2
12/01/2013,CHU de Strasbourg(Hautepierre),Urgences chirurgicales pédiatriques,17,0,37,54,7,7,0
12/01/2013,CHU de Strasbourg(Hautepierre),Gynéco-Obstétrique (HTP),0,0,30,30,9,0,0
12/01/2013,CHU de Strasbourg(Hautepierre),Urgences Adulte HTP,0,22,72,94,46,0,0
12/01/2013,CHU de Strasbourg(Hautepierre),Urgences chirurgicales pédiatriques,3,0,43,46,5,5,0
12/01/2013,Clinique des 3 Frontières,UPATOU (Structure des urgences),0,6,28,34,6,0,0
12/01/2013,Clinique des Diaconesses,SOS Main,0,1,25,26,0,0,0
12/01/2013,Clinique Ste Odile (Strasbourg,UPATOU,0,5,67,72,1,3,1
12/01/2013,CMCO,GYNECO-OBSTETRIQUE,0,0,0,0,0,0,0
12/01/2013,SIHCUS/CMCO,GYNECOLOGIE ET OBSTETRIQUE - CMCO,0,0,0,0,0,0,0
11/01/2013,CCOM,CCOM Chirurgie,0,1,14,15,0,0,0
11/01/2013,CH Altkirch,Upatou,0,6,22,28,2,2,0
11/01/2013,CH de Colmar (CMC Le Parc),SAU Le Parc,11,0,26,37,0,10,0
11/01/2013,CH de Colmar (Louis Pasteur),SAU Pasteur,0,23,105,128,23,15,5
11/01/2013,CH de Guebwiller,UHTCD,0,4,19,23,1,3,0
11/01/2013,CH de Mulhouse ( Hasenrain),PEDIATRIE NEONATOLOGIE,15,0,30,45,11,3,0
11/01/2013,CH de Mulhouse (Emile Muller-Moenschberg,URGENCES,1,30,86,117,17,14,7
11/01/2013,CH de Saverne,S.A.U. (ADULTES),0,10,36,46,11,3,1
11/01/2013,CH de Saverne,PEDIATRIE,4,0,6,10,2,0,0
11/01/2013,CH de Sélestat,Acceuil des urgences,1,11,59,71,14,4,0
11/01/2013,CH de Thann,Urgences,1,9,19,29,4,1,2
11/01/2013,CH de Wissembourg,Urgences ,0,1,25,26,3,0,1
11/01/2013,CHU de Strasbourg (Hôp. Civil),Urgences Médico-Chirurgicales NHC,0,19,58,77,43,1,0
11/01/2013,CHU de Strasbourg(Hautepierre),Urgences chirurgicales pédiatriques,17,0,31,48,7,7,0
11/01/2013,CHU de Strasbourg(Hautepierre),Urgences chirurgicales pédiatriques,1,0,46,47,10,10,0
11/01/2013,CHU de Strasbourg(Hautepierre),Gynéco-Obstétrique (HTP),0,0,30,30,15,0,0
11/01/2013,CHU de Strasbourg(Hautepierre),Urgences Adulte HTP,0,17,90,107,36,0,1
11/01/2013,Clinique des 3 Frontières,UPATOU (Structure des urgences),1,3,28,32,3,1,0
11/01/2013,Clinique des Diaconesses,SOS Main,0,0,25,25,8,0,0
11/01/2013,Clinique Ste Odile (Strasbourg,UPATOU,1,7,48,56,0,4,1
11/01/2013,CMCO,GYNECO-OBSTETRIQUE,0,0,0,0,0,0,0
11/01/2013,SIHCUS/CMCO,GYNECOLOGIE ET OBSTETRIQUE - CMCO,0,0,0,0,0,0,0
10/01/2013,CCOM,CCOM Chirurgie,0,1,10,11,2,0,0
10/01/2013,CH Altkirch,Upatou,0,6,27,33,4,2,0
10/01/2013,CH de Colmar (CMC Le Parc),SAU Le Parc,8,0,48,56,11,0,0
10/01/2013,CH de Colmar (Louis Pasteur),SAU Pasteur,0,22,94,116,19,7,0
10/01/2013,CH de Guebwiller,UHTCD,0,6,40,46,2,4,2
10/01/2013,CH de Mulhouse ( Hasenrain),PEDIATRIE NEONATOLOGIE,13,0,28,41,6,0,0
10/01/2013,CH de Mulhouse (Emile Muller-Moenschberg,URGENCES,0,20,88,108,13,10,1
10/01/2013,CH de Saverne,PEDIATRIE,6,0,19,25,2,0,1
10/01/2013,CH de Saverne,S.A.U. (ADULTES),0,11,47,58,13,3,1
10/01/2013,CH de Sélestat,Acceuil des urgences,4,7,64,75,13,2,0
10/01/2013,CH de Thann,Urgences,0,6,34,40,3,2,0
10/01/2013,CH de Wissembourg,Urgences ,1,7,29,37,8,2,0
10/01/2013,CHU de Strasbourg (Hôp. Civil),Urgences Médico-Chirurgicales NHC,0,11,54,65,30,1,3
10/01/2013,CHU de Strasbourg(Hautepierre),Urgences chirurgicales pédiatriques,5,0,48,53,10,10,0
10/01/2013,CHU de Strasbourg(Hautepierre),Urgences chirurgicales pédiatriques,12,0,46,58,12,10,0
10/01/2013,CHU de Strasbourg(Hautepierre),Urgences Adulte HTP,0,15,78,93,29,0,0
10/01/2013,CHU de Strasbourg(Hautepierre),Gynéco-Obstétrique (HTP),0,0,32,32,13,0,0
10/01/2013,Clinique des 3 Frontières,UPATOU (Structure des urgences),1,3,44,48,6,0,0
10/01/2013,Clinique des Diaconesses,SOS Main,0,2,26,28,28,5,0
10/01/2013,Clinique Ste Odile (Strasbourg,UPATOU,0,3,60,63,0,3,2
10/01/2013,CMCO,GYNECO-OBSTETRIQUE,0,0,0,0,0,0,0
10/01/2013,SIHCUS/CMCO,GYNECOLOGIE ET OBSTETRIQUE - CMCO,0,0,0,0,0,0,0
9/01/2013,CCOM,CCOM Chirurgie,1,1,28,30,3,0,0
9/01/2013,CH Altkirch,Upatou,0,5,21,26,2,2,2
9/01/2013,CH de Colmar (CMC Le Parc),SAU Le Parc,6,0,35,41,5,0,0
9/01/2013,CH de Colmar (Louis Pasteur),SAU Pasteur,0,25,111,136,24,12,2
9/01/2013,CH de Guebwiller,UHTCD,0,4,39,43,1,0,1
9/01/2013,CH de Mulhouse ( Hasenrain),PEDIATRIE NEONATOLOGIE,14,0,25,39,4,1,0
9/01/2013,CH de Mulhouse (Emile Muller-Moenschberg,URGENCES,1,19,99,119,18,11,8
9/01/2013,CH de Saverne,PEDIATRIE,2,0,21,23,1,1,0
9/01/2013,CH de Saverne,S.A.U. (ADULTES),0,6,24,30,6,6,1
9/01/2013,CH de Sélestat,Acceuil des urgences,1,7,48,56,8,4,3
9/01/2013,CH de Thann,Urgences,0,3,34,37,2,1,1
9/01/2013,CH de Wissembourg,Urgences ,1,5,24,30,4,3,1
9/01/2013,CHU de Strasbourg (Hôp. Civil),Urgences Médico-Chirurgicales NHC,0,18,51,69,40,0,0
9/01/2013,CHU de Strasbourg(Hautepierre),Urgences chirurgicales pédiatriques,20,0,50,70,9,7,0
9/01/2013,CHU de Strasbourg(Hautepierre),Gynéco-Obstétrique (HTP),2,0,18,20,12,0,0
9/01/2013,CHU de Strasbourg(Hautepierre),Urgences chirurgicales pédiatriques,1,0,52,53,7,7,0
9/01/2013,CHU de Strasbourg(Hautepierre),Urgences Adulte HTP,0,17,70,87,40,0,1
9/01/2013,Clinique des 3 Frontières,UPATOU (Structure des urgences),0,6,32,38,5,0,2
9/01/2013,Clinique Ste Odile (Strasbourg,UPATOU,0,4,57,61,0,5,5
9/01/2013,CMCO,GYNECO-OBSTETRIQUE,0,0,0,0,0,0,0
9/01/2013,SIHCUS/CMCO,GYNECOLOGIE ET OBSTETRIQUE - CMCO,0,0,0,0,0,0,0
8/01/2013,CCOM,CCOM Chirurgie,0,1,15,16,2,0,0
8/01/2013,CH Altkirch,Upatou,0,6,30,36,2,2,4
8/01/2013,CH de Colmar (CMC Le Parc),SAU Le Parc,6,0,43,49,12,0,0
8/01/2013,CH de Colmar (Louis Pasteur),SAU Pasteur,0,25,87,112,17,10,0
8/01/2013,CH de Guebwiller,UHTCD,0,3,41,44,1,1,0
8/01/2013,CH de Mulhouse ( Hasenrain),PEDIATRIE NEONATOLOGIE,14,0,23,37,6,2,0
8/01/2013,CH de Mulhouse (Emile Muller-Moenschberg,URGENCES,0,29,97,126,17,10,4
8/01/2013,CH de Saverne,S.A.U. (ADULTES),0,10,45,55,10,6,1
8/01/2013,CH de Saverne,PEDIATRIE,4,0,13,17,2,1,0
8/01/2013,CH de Sélestat,Acceuil des urgences,2,20,62,84,18,7,3
8/01/2013,CH de Thann,Urgences,0,7,33,40,3,0,1
8/01/2013,CH de Wissembourg,Urgences ,1,7,15,23,8,0,0
8/01/2013,CHU de Strasbourg (Hôp. Civil),Urgences Médico-Chirurgicales NHC,0,16,65,81,38,2,0
8/01/2013,CHU de Strasbourg(Hautepierre),Urgences chirurgicales pédiatriques,1,0,39,40,1,2,0
8/01/2013,CHU de Strasbourg(Hautepierre),Urgences chirurgicales pédiatriques,16,0,36,52,14,13,0
8/01/2013,CHU de Strasbourg(Hautepierre),Urgences Adulte HTP,0,18,79,97,35,0,1
8/01/2013,CHU de Strasbourg(Hautepierre),Gynéco-Obstétrique (HTP),0,0,31,31,16,0,0
8/01/2013,Clinique des 3 Frontières,UPATOU (Structure des urgences),1,7,40,48,6,0,0
8/01/2013,Clinique Ste Odile (Strasbourg,UPATOU,0,3,66,69,1,11,3
8/01/2013,CMCO,GYNECO-OBSTETRIQUE,0,0,0,0,0,0,0
8/01/2013,SIHCUS/CMCO,GYNECOLOGIE ET OBSTETRIQUE - CMCO,0,0,0,0,0,0,0
7/01/2013,CCOM,CCOM Chirurgie,0,3,30,33,4,0,0
7/01/2013,CH Altkirch,Upatou,0,5,25,30,3,1,0
7/01/2013,CH de Colmar (CMC Le Parc),SAU Le Parc,0,0,40,40,8,0,0
7/01/2013,CH de Colmar (Louis Pasteur),SAU Pasteur,0,24,91,115,17,11,1
7/01/2013,CH de Guebwiller,UHTCD,0,4,30,34,1,2,0
7/01/2013,CH de Mulhouse ( Hasenrain),PEDIATRIE NEONATOLOGIE,23,0,32,55,6,1,0
7/01/2013,CH de Mulhouse (Emile Muller-Moenschberg,URGENCES,0,23,102,125,9,13,2
7/01/2013,CH de Saverne,PEDIATRIE,7,0,14,21,3,0,0
7/01/2013,CH de Saverne,S.A.U. (ADULTES),0,7,38,45,5,7,1
7/01/2013,CH de Sélestat,Acceuil des urgences,1,16,67,84,16,6,0
7/01/2013,CH de Thann,Urgences,0,10,31,41,6,1,0
7/01/2013,CH de Wissembourg,Urgences ,0,4,27,31,5,0,0
7/01/2013,CHU de Strasbourg (Hôp. Civil),Urgences Médico-Chirurgicales NHC,0,25,44,69,46,3,0
7/01/2013,CHU de Strasbourg(Hautepierre),Urgences chirurgicales pédiatriques,1,0,36,37,6,6,0
7/01/2013,CHU de Strasbourg(Hautepierre),Urgences Adulte HTP,0,26,77,103,43,0,0
7/01/2013,CHU de Strasbourg(Hautepierre),Urgences chirurgicales pédiatriques,13,0,33,46,13,11,0
7/01/2013,CHU de Strasbourg(Hautepierre),Gynéco-Obstétrique (HTP),1,0,24,25,10,0,0
7/01/2013,Clinique des 3 Frontières,UPATOU (Structure des urgences),1,1,36,38,3,0,0
7/01/2013,Clinique Ste Odile (Strasbourg,UPATOU,1,3,53,57,2,6,0
7/01/2013,CMCO,GYNECO-OBSTETRIQUE,0,0,0,0,0,0,0
7/01/2013,SIHCUS/CMCO,GYNECOLOGIE ET OBSTETRIQUE - CMCO,0,0,0,0,0,0,0
6/01/2013,CCOM,CCOM Chirurgie,0,0,14,14,2,0,0
6/01/2013,CH Altkirch,Upatou,0,6,38,44,4,1,1
6/01/2013,CH de Colmar (CMC Le Parc),SAU Le Parc,11,0,41,52,6,0,0
6/01/2013,CH de Colmar (Louis Pasteur),SAU Pasteur,0,17,100,117,17,8,1
6/01/2013,CH de Guebwiller,UHTCD,0,5,37,42,0,3,1
6/01/2013,CH de Mulhouse ( Hasenrain),PEDIATRIE NEONATOLOGIE,19,0,34,53,2,3,0
6/01/2013,CH de Mulhouse (Emile Muller-Moenschberg,URGENCES,0,22,108,130,8,12,6
6/01/2013,CH de Saverne,PEDIATRIE,6,0,16,22,4,2,0
6/01/2013,CH de Saverne,S.A.U. (ADULTES),0,10,38,48,7,4,1
6/01/2013,CH de Sélestat,Acceuil des urgences,1,9,58,68,12,5,1
6/01/2013,CH de Thann,Urgences,1,8,35,44,4,3,4
6/01/2013,CH de Wissembourg,Urgences ,2,12,22,36,6,2,0
6/01/2013,CHU de Strasbourg (Hôp. Civil),Urgences Médico-Chirurgicales NHC,0,17,77,94,36,0,0
6/01/2013,CHU de Strasbourg(Hautepierre),Urgences chirurgicales pédiatriques,17,0,50,67,5,5,0
6/01/2013,CHU de Strasbourg(Hautepierre),Gynéco-Obstétrique (HTP),0,0,22,22,5,0,0
6/01/2013,CHU de Strasbourg(Hautepierre),Urgences Adulte HTP,0,14,72,86,26,0,0
6/01/2013,CHU de Strasbourg(Hautepierre),Urgences chirurgicales pédiatriques,4,0,30,34,4,4,0
6/01/2013,Clinique des 3 Frontières,UPATOU (Structure des urgences),2,3,34,39,9,0,1
6/01/2013,Clinique des Diaconesses,SOS Main,0,2,27,29,0,0,0
6/01/2013,Clinique Ste Odile (Strasbourg,UPATOU,0,5,74,79,1,10,0
6/01/2013,CMCO,GYNECO-OBSTETRIQUE,0,0,0,0,0,0,0
6/01/2013,SIHCUS/CMCO,GYNECOLOGIE ET OBSTETRIQUE - CMCO,0,0,0,0,0,0,0
5/01/2013,CCOM,CCOM Chirurgie,0,1,17,18,2,0,0
5/01/2013,CH Altkirch,Upatou,0,10,25,35,6,1,2
5/01/2013,CH de Colmar (CMC Le Parc),SAU Le Parc,8,0,39,47,4,1,0
5/01/2013,CH de Colmar (Louis Pasteur),SAU Pasteur,0,25,75,100,18,7,4
5/01/2013,CH de Guebwiller,UHTCD,0,5,39,44,0,2,1
5/01/2013,CH de Mulhouse ( Hasenrain),PEDIATRIE NEONATOLOGIE,18,0,21,39,7,0,0
5/01/2013,CH de Mulhouse (Emile Muller-Moenschberg,URGENCES,4,20,116,140,11,13,6
5/01/2013,CH de Saverne,PEDIATRIE,5,0,13,18,3,0,0
5/01/2013,CH de Saverne,S.A.U. (ADULTES),0,15,36,51,9,5,0
5/01/2013,CH de Sélestat,Acceuil des urgences,1,12,72,85,26,4,1
5/01/2013,CH de Wissembourg,Urgences ,2,12,24,38,2,4,0
5/01/2013,CHU de Strasbourg (Hôp. Civil),Urgences Médico-Chirurgicales NHC,0,25,82,107,40,2,1
5/01/2013,CHU de Strasbourg(Hautepierre),Urgences chirurgicales pédiatriques,0,0,47,47,5,5,0
5/01/2013,CHU de Strasbourg(Hautepierre),Urgences Adulte HTP,0,20,84,104,32,0,0
5/01/2013,CHU de Strasbourg(Hautepierre),Urgences chirurgicales pédiatriques,19,0,48,67,11,9,0
5/01/2013,CHU de Strasbourg(Hautepierre),Gynéco-Obstétrique (HTP),0,0,32,32,10,0,0
5/01/2013,Clinique des 3 Frontières,UPATOU (Structure des urgences),1,5,42,48,7,0,1
5/01/2013,Clinique des Diaconesses,SOS Main,0,1,25,26,0,0,0
5/01/2013,Clinique Ste Odile (Strasbourg,UPATOU,0,2,68,70,1,5,4
5/01/2013,CMCO,GYNECO-OBSTETRIQUE,0,0,0,0,0,0,0
5/01/2013,SIHCUS/CMCO,GYNECOLOGIE ET OBSTETRIQUE - CMCO,0,0,0,0,0,0,0
4/01/2013,CCOM,CCOM Chirurgie,0,2,11,13,0,0,0
4/01/2013,CH Altkirch,Upatou,0,12,29,41,4,4,0
4/01/2013,CH de Colmar (CMC Le Parc),SAU Le Parc,12,0,30,42,10,0,0
4/01/2013,CH de Colmar (Louis Pasteur),SAU Pasteur,0,24,111,135,24,12,0
4/01/2013,CH de Guebwiller,UHTCD,0,4,26,30,2,3,1
4/01/2013,CH de Mulhouse ( Hasenrain),PEDIATRIE NEONATOLOGIE,19,0,26,45,7,3,0
4/01/2013,CH de Mulhouse (Emile Muller-Moenschberg,URGENCES,1,16,117,134,13,16,1
4/01/2013,CH de Saverne,S.A.U. (ADULTES),0,15,25,40,11,2,0
4/01/2013,CH de Saverne,PEDIATRIE,7,0,11,18,3,0,0
4/01/2013,CH de Sélestat,Acceuil des urgences,3,15,47,65,15,4,3
4/01/2013,CH de Thann,Urgences,0,10,26,36,4,2,3
4/01/2013,CH de Wissembourg,Urgences ,2,7,15,24,8,1,0
4/01/2013,CHU de Strasbourg (Hôp. Civil),Urgences Médico-Chirurgicales NHC,1,20,56,77,41,4,1
4/01/2013,CHU de Strasbourg(Hautepierre),Urgences chirurgicales pédiatriques,3,0,33,36,2,2,0
4/01/2013,CHU de Strasbourg(Hautepierre),Urgences chirurgicales pédiatriques,25,0,42,67,10,9,0
4/01/2013,CHU de Strasbourg(Hautepierre),Gynéco-Obstétrique (HTP),0,0,25,25,8,0,0
4/01/2013,CHU de Strasbourg(Hautepierre),Urgences Adulte HTP,0,17,73,90,49,0,0
4/01/2013,Clinique des 3 Frontières,UPATOU (Structure des urgences),1,5,37,43,5,0,1
4/01/2013,Clinique Ste Odile (Strasbourg,UPATOU,0,5,62,67,0,7,3
4/01/2013,CMCO,GYNECO-OBSTETRIQUE,0,0,0,0,0,0,0
4/01/2013,SIHCUS/CMCO,GYNECOLOGIE ET OBSTETRIQUE - CMCO,0,0,0,0,0,0,0
3/01/2013,CCOM,CCOM Chirurgie,0,3,25,28,2,0,0
3/01/2013,CH Altkirch,Upatou,0,7,28,35,2,4,0
3/01/2013,CH de Colmar (CMC Le Parc),SAU Le Parc,12,0,23,35,8,0,0
3/01/2013,CH de Colmar (Louis Pasteur),SAU Pasteur,0,26,87,113,25,8,0
3/01/2013,CH de Guebwiller,UHTCD,0,0,42,42,1,1,2
3/01/2013,CH de Mulhouse ( Hasenrain),PEDIATRIE NEONATOLOGIE,22,0,30,52,3,3,0
3/01/2013,CH de Mulhouse (Emile Muller-Moenschberg,URGENCES,0,21,97,118,18,8,4
3/01/2013,CH de Saverne,S.A.U. (ADULTES),0,9,37,46,9,2,0
3/01/2013,CH de Saverne,PEDIATRIE,6,0,12,18,3,0,0
3/01/2013,CH de Sélestat,Acceuil des urgences,0,6,71,77,10,5,3
3/01/2013,CH de Thann,Urgences,0,7,36,43,5,6,1
3/01/2013,CH de Wissembourg,Urgences ,1,6,29,36,10,2,0
3/01/2013,CHU de Strasbourg (Hôp. Civil),Urgences Médico-Chirurgicales NHC,0,24,51,75,39,1,0
3/01/2013,CHU de Strasbourg(Hautepierre),Urgences chirurgicales pédiatriques,3,0,25,28,3,3,0
3/01/2013,CHU de Strasbourg(Hautepierre),Urgences chirurgicales pédiatriques,12,0,25,37,5,6,0
3/01/2013,CHU de Strasbourg(Hautepierre),Gynéco-Obstétrique (HTP),0,0,24,24,10,0,0
3/01/2013,CHU de Strasbourg(Hautepierre),Urgences Adulte HTP,0,16,79,95,45,0,0
3/01/2013,Clinique des 3 Frontières,UPATOU (Structure des urgences),1,4,36,41,2,1,1
3/01/2013,Clinique Ste Odile (Strasbourg,UPATOU,1,4,50,55,1,9,4
3/01/2013,CMCO,GYNECO-OBSTETRIQUE,0,0,0,0,0,0,0
3/01/2013,SIHCUS/CMCO,GYNECOLOGIE ET OBSTETRIQUE - CMCO,0,0,0,0,0,0,0
2/01/2013,CCOM,CCOM Chirurgie,0,2,20,22,1,0,0
2/01/2013,CH Altkirch,Upatou,0,3,44,47,2,2,1
2/01/2013,CH de Colmar (CMC Le Parc),SAU Le Parc,12,0,35,47,10,0,0
2/01/2013,CH de Colmar (Louis Pasteur),SAU Pasteur,0,25,120,145,26,10,0
2/01/2013,CH de Guebwiller,UHTCD,0,3,42,45,1,4,7
2/01/2013,CH de Mulhouse ( Hasenrain),PEDIATRIE NEONATOLOGIE,12,0,27,39,6,2,1
2/01/2013,CH de Mulhouse (Emile Muller-Moenschberg,URGENCES,1,29,103,133,29,16,6
2/01/2013,CH de Saverne,PEDIATRIE,9,0,19,28,5,2,0
2/01/2013,CH de Saverne,S.A.U. (ADULTES),0,14,33,47,14,4,1
2/01/2013,CH de Sélestat,Acceuil des urgences,2,15,63,80,19,4,6
2/01/2013,CH de Thann,Urgences,0,10,39,49,4,1,3
2/01/2013,CH de Wissembourg,Urgences ,0,10,38,48,6,0,0
2/01/2013,CHU de Strasbourg (Hôp. Civil),Urgences Médico-Chirurgicales NHC,0,26,61,87,59,3,1
2/01/2013,CHU de Strasbourg(Hautepierre),Urgences chirurgicales pédiatriques,3,0,29,32,4,4,0
2/01/2013,CHU de Strasbourg(Hautepierre),Urgences chirurgicales pédiatriques,20,0,68,88,10,8,0
2/01/2013,CHU de Strasbourg(Hautepierre),Gynéco-Obstétrique (HTP),1,0,38,39,21,0,0
2/01/2013,CHU de Strasbourg(Hautepierre),Urgences Adulte HTP,0,26,70,96,45,0,1
2/01/2013,Clinique des 3 Frontières,UPATOU (Structure des urgences),1,6,31,38,4,0,0
2/01/2013,Clinique des Diaconesses,SOS Main,0,1,35,36,0,0,0
2/01/2013,Clinique Ste Odile (Strasbourg,UPATOU,1,4,64,69,3,7,0
2/01/2013,CMCO,GYNECO-OBSTETRIQUE,0,0,0,0,0,0,0
2/01/2013,SIHCUS/CMCO,GYNECOLOGIE ET OBSTETRIQUE - CMCO,0,0,0,0,0,0,0
1/01/2013,CCOM,CCOM Chirurgie,0,0,28,28,7,0,0
1/01/2013,CH Altkirch,Upatou,0,3,45,48,8,1,2
1/01/2013,CH de Colmar (CMC Le Parc),SAU Le Parc,17,0,42,59,13,0,0
1/01/2013,CH de Colmar (Louis Pasteur),SAU Pasteur,0,27,120,147,30,9,0
1/01/2013,CH de Guebwiller,UHTCD,1,4,40,45,0,2,0
1/01/2013,CH de Mulhouse ( Hasenrain),PEDIATRIE NEONATOLOGIE,16,0,36,52,5,1,0
1/01/2013,CH de Mulhouse (Emile Muller-Moenschberg,URGENCES,1,18,125,144,19,10,3
1/01/2013,CH de Saverne,S.A.U. (ADULTES),0,8,44,52,5,3,1
1/01/2013,CH de Saverne,PEDIATRIE,6,0,27,33,6,0,0
1/01/2013,CH de Sélestat,Acceuil des urgences,5,16,91,112,22,5,1
1/01/2013,CH de Thann,Urgences,2,5,34,41,3,2,3
1/01/2013,CH de Wissembourg,Urgences ,0,4,28,32,4,0,0
1/01/2013,CHU de Strasbourg (Hôp. Civil),Urgences Médico-Chirurgicales NHC,0,15,117,132,47,6,0
1/01/2013,CHU de Strasbourg(Hautepierre),Urgences Adulte HTP,0,14,113,127,43,0,0
1/01/2013,CHU de Strasbourg(Hautepierre),Urgences chirurgicales pédiatriques,20,0,66,86,14,14,0
1/01/2013,CHU de Strasbourg(Hautepierre),Gynéco-Obstétrique (HTP),0,0,27,27,12,0,0
1/01/2013,CHU de Strasbourg(Hautepierre),Urgences chirurgicales pédiatriques,4,0,34,38,2,2,0
1/01/2013,Clinique des 3 Frontières,UPATOU (Structure des urgences),0,9,51,60,7,0,1
1/01/2013,Clinique des Diaconesses,SOS Main,0,2,42,44,1,0,0
1/01/2013,Clinique Ste Odile (Strasbourg,UPATOU,3,3,79,85,0,5,3
1/01/2013,CMCO,GYNECO-OBSTETRIQUE,0,0,0,0,0,0,0
1/01/2013,SIHCUS/CMCO,GYNECOLOGIE ET OBSTETRIQUE - CMCO,0,0,0,0,0,0,0
19/03/2013,CCOM,CCOM Chirurgie,0,2,25,27,1,0,0
19/03/2013,CH Altkirch,Upatou,0,4,36,40,4,2,4
19/03/2013,CH de Colmar (CMC Le Parc),SAU Le Parc,10,0,30,40,11,0,0
19/03/2013,CH de Colmar (Louis Pasteur),SAU Pasteur,1,24,89,114,18,12,0
19/03/2013,CH de Guebwiller,UHTCD,0,6,39,45,5,1,8
19/03/2013,CH de Saverne,PEDIATRIE,5,0,21,26,2,2,1
19/03/2013,CH de Saverne,S.A.U. (ADULTES),0,5,30,35,5,3,0
19/03/2013,CH de Sélestat,Acceuil des urgences,1,12,69,82,15,5,3
19/03/2013,CH de Thann,Urgences,0,7,33,40,6,0,1
19/03/2013,CHU de Strasbourg (Hôp. Civil),Urgences Médico-Chirurgicales NHC,0,19,66,85,53,3,1
19/03/2013,CHU de Strasbourg(Hautepierre),Urgences chirurgicales pédiatriques,2,0,53,55,5,4,0
19/03/2013,CHU de Strasbourg(Hautepierre),Urgences chirurgicales pédiatriques,12,0,44,56,6,5,0
19/03/2013,CHU de Strasbourg(Hautepierre),Gynéco-Obstétrique (HTP),0,0,27,27,16,0,0
19/03/2013,CHU de Strasbourg(Hautepierre),Urgences Adulte HTP,0,20,81,101,39,0,0
19/03/2013,Clinique des 3 Frontières,UPATOU (Structure des urgences),1,3,37,41,5,0,0
19/03/2013,Clinique des Diaconesses,SOS Main,0,3,35,38,14,2,1
19/03/2013,Clinique Ste Odile (Strasbourg,UPATOU,0,5,59,64,1,2,3
19/03/2013,CMCO,GYNECO-OBSTETRIQUE,0,0,0,0,0,0,0
19/03/2013,SIHCUS/CMCO,GYNECOLOGIE ET OBSTETRIQUE - CMCO,0,0,0,0,0,0,0
18/03/2013,CCOM,CCOM Chirurgie,0,1,30,31,2,0,0
18/03/2013,CH Altkirch,Upatou,0,9,42,51,6,1,8
18/03/2013,CH de Colmar (CMC Le Parc),SAU Le Parc,7,0,32,39,11,0,0
18/03/2013,CH de Colmar (Louis Pasteur),SAU Pasteur,2,29,96,127,23,11,1
18/03/2013,CH de Guebwiller,UHTCD,0,9,45,54,3,2,3
18/03/2013,CH de Mulhouse ( Hasenrain),PEDIATRIE NEONATOLOGIE,4,0,33,37,5,3,0
18/03/2013,CH de Mulhouse (Emile Muller-Moenschberg,URGENCES,1,15,115,131,22,12,6
18/03/2013,CH de Saverne,PEDIATRIE,4,0,13,17,2,0,0
18/03/2013,CH de Saverne,S.A.U. (ADULTES),0,15,46,61,14,4,1
18/03/2013,CH de Sélestat,Acceuil des urgences,1,24,71,96,20,4,4
18/03/2013,CH de Thann,Urgences,0,5,38,43,8,1,2
18/03/2013,CHU de Strasbourg (Hôp. Civil),Urgences Médico-Chirurgicales NHC,0,20,70,90,49,1,1
18/03/2013,CHU de Strasbourg(Hautepierre),Urgences chirurgicales pédiatriques,14,0,46,60,6,5,0
18/03/2013,CHU de Strasbourg(Hautepierre),Gynéco-Obstétrique (HTP),0,0,20,20,12,0,0
18/03/2013,CHU de Strasbourg(Hautepierre),Urgences Adulte HTP,0,23,97,120,46,1,0
18/03/2013,CHU de Strasbourg(Hautepierre),Urgences chirurgicales pédiatriques,5,0,64,69,6,5,0
18/03/2013,Clinique des 3 Frontières,UPATOU (Structure des urgences),0,4,48,52,6,0,0
18/03/2013,Clinique des Diaconesses,SOS Main,0,2,32,34,9,1,0
18/03/2013,Clinique Ste Odile (Strasbourg,UPATOU,1,2,77,80,3,11,1
18/03/2013,CMCO,GYNECO-OBSTETRIQUE,0,0,0,0,0,0,0
18/03/2013,SIHCUS/CMCO,GYNECOLOGIE ET OBSTETRIQUE - CMCO,0,0,42,42,1,0,0
17/03/2013,CCOM,CCOM Chirurgie,0,1,13,14,2,0,0
17/03/2013,CH de Colmar (CMC Le Parc),SAU Le Parc,9,0,36,45,5,0,2
17/03/2013,CH de Colmar (Louis Pasteur),SAU Pasteur,0,19,95,114,16,10,0
17/03/2013,CH de Guebwiller,UHTCD,0,4,37,41,3,1,2
17/03/2013,CH de Mulhouse ( Hasenrain),PEDIATRIE NEONATOLOGIE,11,0,25,36,4,4,0
17/03/2013,CH de Mulhouse (Emile Muller-Moenschberg,URGENCES,0,18,115,133,6,4,6
17/03/2013,CH de Saverne,S.A.U. (ADULTES),0,9,38,47,5,5,0
17/03/2013,CH de Saverne,PEDIATRIE,5,0,29,34,8,2,0
17/03/2013,CH de Sélestat,Acceuil des urgences,1,8,82,91,10,2,0
17/03/2013,CH de Thann,Urgences,0,8,31,39,2,1,2
17/03/2013,CH de Wissembourg,Urgences ,1,3,30,34,4,2,0
17/03/2013,CHU de Strasbourg (Hôp. Civil),Urgences Médico-Chirurgicales NHC,1,13,71,85,31,3,1
17/03/2013,CHU de Strasbourg(Hautepierre),Urgences chirurgicales pédiatriques,21,0,50,71,12,12,0
17/03/2013,CHU de Strasbourg(Hautepierre),Gynéco-Obstétrique (HTP),0,0,25,25,7,0,0
17/03/2013,CHU de Strasbourg(Hautepierre),Urgences chirurgicales pédiatriques,2,0,40,42,1,1,0
17/03/2013,CHU de Strasbourg(Hautepierre),Urgences Adulte HTP,0,9,88,97,30,0,1
17/03/2013,Clinique des 3 Frontières,UPATOU (Structure des urgences),2,1,46,49,2,0,1
17/03/2013,Clinique Ste Odile (Strasbourg,UPATOU,1,2,79,82,0,5,0
17/03/2013,CMCO,GYNECO-OBSTETRIQUE,0,0,0,0,0,0,0
17/03/2013,SIHCUS/CMCO,GYNECOLOGIE ET OBSTETRIQUE - CMCO,0,0,0,0,0,0,0
16/03/2013,CCOM,CCOM Chirurgie,0,0,10,10,1,0,0
16/03/2013,CH Altkirch,Upatou,1,6,38,45,5,1,2
16/03/2013,CH de Colmar (CMC Le Parc),SAU Le Parc,11,0,29,40,9,0,0
16/03/2013,CH de Colmar (Louis Pasteur),SAU Pasteur,0,20,92,112,28,4,2
16/03/2013,CH de Guebwiller,UHTCD,0,2,39,41,2,2,1
16/03/2013,CH de Mulhouse ( Hasenrain),PEDIATRIE NEONATOLOGIE,11,0,30,41,2,3,1
16/03/2013,CH de Mulhouse (Emile Muller-Moenschberg,URGENCES,1,24,115,140,7,12,1
16/03/2013,CH de Saverne,PEDIATRIE,8,0,22,30,3,0,0
16/03/2013,CH de Saverne,S.A.U. (ADULTES),0,11,31,42,7,1,0
16/03/2013,CH de Sélestat,Acceuil des urgences,0,7,63,70,10,5,2
16/03/2013,CH de Thann,Urgences,1,3,54,58,1,0,1
16/03/2013,CH de Wissembourg,Urgences ,1,6,39,46,8,2,0
16/03/2013,CHU de Strasbourg (Hôp. Civil),Urgences Médico-Chirurgicales NHC,0,21,76,97,37,7,0
16/03/2013,CHU de Strasbourg(Hautepierre),Urgences chirurgicales pédiatriques,23,0,53,76,12,11,0
16/03/2013,CHU de Strasbourg(Hautepierre),Gynéco-Obstétrique (HTP),0,0,30,30,13,0,0
16/03/2013,CHU de Strasbourg(Hautepierre),Urgences Adulte HTP,0,13,58,71,23,0,0
16/03/2013,CHU de Strasbourg(Hautepierre),Urgences chirurgicales pédiatriques,3,0,52,55,6,6,0
16/03/2013,Clinique des 3 Frontières,UPATOU (Structure des urgences),0,4,35,39,7,0,0
16/03/2013,Clinique Ste Odile (Strasbourg,UPATOU,1,7,67,75,4,7,2
16/03/2013,CMCO,GYNECO-OBSTETRIQUE,0,0,0,0,0,0,0
16/03/2013,SIHCUS/CMCO,GYNECOLOGIE ET OBSTETRIQUE - CMCO,0,0,0,0,0,0,0
15/03/2013,CCOM,CCOM Chirurgie,0,3,14,17,0,0,0
15/03/2013,CH Altkirch,Upatou,0,9,37,46,6,3,2
15/03/2013,CH de Colmar (CMC Le Parc),SAU Le Parc,0,0,29,29,9,0,0
15/03/2013,CH de Colmar (Louis Pasteur),SAU Pasteur,0,19,122,141,23,14,5
15/03/2013,CH de Guebwiller,UHTCD,0,4,36,40,2,1,1
15/03/2013,CH de Mulhouse ( Hasenrain),PEDIATRIE NEONATOLOGIE,11,0,27,38,6,2,0
15/03/2013,CH de Mulhouse (Emile Muller-Moenschberg,URGENCES,1,33,100,134,20,7,5
15/03/2013,CH de Saverne,PEDIATRIE,5,0,17,22,3,0,0
15/03/2013,CH de Saverne,S.A.U. (ADULTES),0,16,45,61,19,8,1
15/03/2013,CH de Sélestat,Acceuil des urgences,2,13,81,96,17,3,4
15/03/2013,CH de Thann,Urgences,0,9,37,46,3,0,0
15/03/2013,CH de Wissembourg,Urgences ,0,9,47,56,12,1,2
15/03/2013,CHU de Strasbourg (Hôp. Civil),Urgences Médico-Chirurgicales NHC,0,17,64,81,41,4,2
15/03/2013,CHU de Strasbourg(Hautepierre),Urgences chirurgicales pédiatriques,14,0,42,56,12,12,0
15/03/2013,CHU de Strasbourg(Hautepierre),Gynéco-Obstétrique (HTP),0,0,26,26,17,0,0
15/03/2013,CHU de Strasbourg(Hautepierre),Urgences chirurgicales pédiatriques,0,0,56,56,7,7,0
15/03/2013,CHU de Strasbourg(Hautepierre),Urgences Adulte HTP,0,17,72,89,39,0,0
15/03/2013,Clinique des 3 Frontières,UPATOU (Structure des urgences),0,5,34,39,2,0,1
15/03/2013,Clinique des Diaconesses,SOS Main,0,35,0,35,14,0,0
15/03/2013,Clinique Ste Odile (Strasbourg,UPATOU,0,7,68,75,0,7,2
15/03/2013,CMCO,GYNECO-OBSTETRIQUE,0,0,0,0,0,0,0
15/03/2013,SIHCUS/CMCO,GYNECOLOGIE ET OBSTETRIQUE - CMCO,0,0,0,0,0,0,0
14/03/2013,CCOM,CCOM Chirurgie,0,2,16,18,1,0,0
14/03/2013,CH Altkirch,Upatou,0,4,33,37,6,1,1
14/03/2013,CH de Colmar (CMC Le Parc),SAU Le Parc,11,0,39,50,12,0,0
14/03/2013,CH de Colmar (Louis Pasteur),SAU Pasteur,0,20,92,112,19,12,0
14/03/2013,CH de Guebwiller,UHTCD,0,3,38,41,1,1,1
14/03/2013,CH de Mulhouse ( Hasenrain),PEDIATRIE NEONATOLOGIE,10,0,26,36,2,1,0
14/03/2013,CH de Mulhouse (Emile Muller-Moenschberg,URGENCES,0,21,100,121,11,15,3
14/03/2013,CH de Saverne,S.A.U. (ADULTES),0,14,33,47,9,4,1
14/03/2013,CH de Saverne,PEDIATRIE,5,0,17,22,5,0,0
14/03/2013,CH de Sélestat,Acceuil des urgences,1,14,77,92,11,3,4
14/03/2013,CH de Thann,Urgences,0,6,31,37,2,0,2
14/03/2013,CHU de Strasbourg (Hôp. Civil),Urgences Médico-Chirurgicales NHC,0,19,52,71,43,2,1
14/03/2013,CHU de Strasbourg(Hautepierre),Urgences chirurgicales pédiatriques,2,0,44,46,5,5,0
14/03/2013,CHU de Strasbourg(Hautepierre),Urgences chirurgicales pédiatriques,12,0,37,49,4,4,0
14/03/2013,CHU de Strasbourg(Hautepierre),Gynéco-Obstétrique (HTP),0,0,15,15,5,0,0
14/03/2013,CHU de Strasbourg(Hautepierre),Urgences Adulte HTP,0,15,84,99,44,0,1
14/03/2013,Clinique des 3 Frontières,UPATOU (Structure des urgences),0,8,38,46,3,0,0
14/03/2013,Clinique des Diaconesses,SOS Main,0,0,39,39,13,0,1
14/03/2013,Clinique Ste Odile (Strasbourg,UPATOU,0,3,44,47,1,4,1
14/03/2013,CMCO,GYNECO-OBSTETRIQUE,0,0,0,0,0,0,0
14/03/2013,SIHCUS/CMCO,GYNECOLOGIE ET OBSTETRIQUE - CMCO,0,0,0,0,0,0,0
13/03/2013,CCOM,CCOM Chirurgie,0,0,24,24,1,0,0
13/03/2013,CH Altkirch,Upatou,0,3,38,41,6,0,0
13/03/2013,CH de Colmar (CMC Le Parc),SAU Le Parc,5,0,37,42,8,0,0
13/03/2013,CH de Colmar (Louis Pasteur),SAU Pasteur,1,13,93,107,21,10,0
13/03/2013,CH de Guebwiller,UHTCD,1,5,40,46,4,0,1
13/03/2013,CH de Mulhouse ( Hasenrain),PEDIATRIE NEONATOLOGIE,9,0,21,30,5,3,0
13/03/2013,CH de Mulhouse (Emile Muller-Moenschberg,URGENCES,0,21,95,116,7,11,1
13/03/2013,CH de Saverne,PEDIATRIE,4,0,21,25,4,0,0
13/03/2013,CH de Saverne,S.A.U. (ADULTES),0,7,39,46,9,4,0
13/03/2013,CH de Sélestat,Acceuil des urgences,0,7,69,76,16,6,4
13/03/2013,CH de Thann,Urgences,1,3,29,33,3,2,1
13/03/2013,CHU de Strasbourg (Hôp. Civil),Urgences Médico-Chirurgicales NHC,0,15,58,73,45,1,1
13/03/2013,CHU de Strasbourg(Hautepierre),Urgences chirurgicales pédiatriques,6,0,48,54,4,4,0
13/03/2013,CHU de Strasbourg(Hautepierre),Urgences chirurgicales pédiatriques,13,0,38,51,8,7,0
13/03/2013,CHU de Strasbourg(Hautepierre),Gynéco-Obstétrique (HTP),0,0,21,21,8,0,0
13/03/2013,CHU de Strasbourg(Hautepierre),Urgences Adulte HTP,0,9,96,105,37,0,1
13/03/2013,Clinique des 3 Frontières,UPATOU (Structure des urgences),2,2,35,39,5,0,1
13/03/2013,Clinique des Diaconesses,SOS Main,0,1,45,46,14,1,0
13/03/2013,Clinique Ste Odile (Strasbourg,UPATOU,0,4,59,63,3,6,1
13/03/2013,CMCO,GYNECO-OBSTETRIQUE,0,0,0,0,0,0,0
13/03/2013,SIHCUS/CMCO,GYNECOLOGIE ET OBSTETRIQUE - CMCO,0,0,0,0,0,0,0
12/03/2013,CCOM,CCOM Chirurgie,0,1,22,23,0,0,0
12/03/2013,CH Altkirch,Upatou,1,4,31,36,4,1,1
12/03/2013,CH de Colmar (CMC Le Parc),SAU Le Parc,6,0,31,37,7,0,0
12/03/2013,CH de Colmar (Louis Pasteur),SAU Pasteur,0,15,96,111,15,14,1
12/03/2013,CH de Guebwiller,UHTCD,0,3,33,36,3,2,0
12/03/2013,CH de Mulhouse ( Hasenrain),PEDIATRIE NEONATOLOGIE,12,0,21,33,7,2,0
12/03/2013,CH de Mulhouse (Emile Muller-Moenschberg,URGENCES,1,23,97,121,17,11,2
12/03/2013,CH de Saverne,PEDIATRIE,6,0,11,17,3,1,0
12/03/2013,CH de Saverne,S.A.U. (ADULTES),0,10,37,47,7,3,2
12/03/2013,CH de Sélestat,Acceuil des urgences,1,7,65,73,17,8,0
12/03/2013,CH de Thann,Urgences,1,7,41,49,7,2,3
12/03/2013,CHU de Strasbourg (Hôp. Civil),Urgences Médico-Chirurgicales NHC,0,17,66,83,41,1,2
12/03/2013,CHU de Strasbourg(Hautepierre),Urgences chirurgicales pédiatriques,11,0,38,49,13,13,0
12/03/2013,CHU de Strasbourg(Hautepierre),Gynéco-Obstétrique (HTP),0,1,23,24,11,0,0
12/03/2013,CHU de Strasbourg(Hautepierre),Urgences chirurgicales pédiatriques,2,0,40,42,3,3,0
12/03/2013,CHU de Strasbourg(Hautepierre),Urgences Adulte HTP,0,19,75,94,31,0,0
12/03/2013,Clinique des 3 Frontières,UPATOU (Structure des urgences),1,3,29,33,3,0,1
12/03/2013,Clinique Ste Odile (Strasbourg,UPATOU,2,1,62,65,2,6,1
12/03/2013,CMCO,GYNECO-OBSTETRIQUE,0,0,0,0,0,0,0
12/03/2013,SIHCUS/CMCO,GYNECOLOGIE ET OBSTETRIQUE - CMCO,0,0,0,0,0,0,0
11/03/2013,CCOM,CCOM Chirurgie,0,2,18,20,4,0,0
11/03/2013,CH Altkirch,Upatou,0,14,43,57,8,2,2
11/03/2013,CH de Colmar (CMC Le Parc),SAU Le Parc,9,0,34,43,10,0,0
11/03/2013,CH de Colmar (Louis Pasteur),SAU Pasteur,2,29,108,139,18,13,1
11/03/2013,CH de Guebwiller,UHTCD,0,5,44,49,4,0,1
11/03/2013,CH de Mulhouse ( Hasenrain),PEDIATRIE NEONATOLOGIE,11,0,27,38,12,2,0
11/03/2013,CH de Mulhouse (Emile Muller-Moenschberg,URGENCES,3,24,104,131,11,12,9
11/03/2013,CH de Saverne,PEDIATRIE,7,0,16,23,7,0,0
11/03/2013,CH de Saverne,S.A.U. (ADULTES),0,10,50,60,12,4,1
11/03/2013,CH de Sélestat,Acceuil des urgences,0,12,90,102,13,4,7
11/03/2013,CH de Thann,Urgences,0,4,28,32,0,3,4
11/03/2013,CHU de Strasbourg (Hôp. Civil),Urgences Médico-Chirurgicales NHC,0,24,64,88,42,4,2
11/03/2013,CHU de Strasbourg(Hautepierre),Urgences chirurgicales pédiatriques,3,0,46,49,2,2,0
11/03/2013,CHU de Strasbourg(Hautepierre),Urgences chirurgicales pédiatriques,14,0,48,62,9,9,0
11/03/2013,CHU de Strasbourg(Hautepierre),Gynéco-Obstétrique (HTP),0,0,24,24,15,0,0
11/03/2013,CHU de Strasbourg(Hautepierre),Urgences Adulte HTP,0,17,79,96,37,0,1
11/03/2013,Clinique des 3 Frontières,UPATOU (Structure des urgences),0,2,44,46,7,0,2
11/03/2013,Clinique des Diaconesses,SOS Main,0,1,41,42,1,0,0
11/03/2013,CMCO,GYNECO-OBSTETRIQUE,0,0,0,0,0,0,0
11/03/2013,SIHCUS/CMCO,GYNECOLOGIE ET OBSTETRIQUE - CMCO,0,0,0,0,0,0,0
10/03/2013,CCOM,CCOM Chirurgie,0,0,21,21,3,0,0
10/03/2013,CH Altkirch,Upatou,1,8,33,42,8,0,0
10/03/2013,CH de Colmar (CMC Le Parc),SAU Le Parc,16,0,42,58,3,0,1
10/03/2013,CH de Colmar (Louis Pasteur),SAU Pasteur,0,16,110,126,18,6,1
10/03/2013,CH de Guebwiller,UHTCD,0,1,30,31,0,4,0
10/03/2013,CH de Mulhouse ( Hasenrain),PEDIATRIE NEONATOLOGIE,14,0,29,43,2,2,0
10/03/2013,CH de Mulhouse (Emile Muller-Moenschberg,URGENCES,2,23,126,151,12,10,3
10/03/2013,CH de Saverne,PEDIATRIE,4,0,11,15,0,0,0
10/03/2013,CH de Saverne,S.A.U. (ADULTES),0,6,46,52,10,8,1
10/03/2013,CH de Sélestat,Acceuil des urgences,3,7,93,103,10,3,0
10/03/2013,CH de Thann,Urgences,0,2,38,40,2,2,2
10/03/2013,CH de Wissembourg,Urgences ,1,6,31,38,7,1,0
10/03/2013,CHU de Strasbourg (Hôp. Civil),Urgences Médico-Chirurgicales NHC,0,15,62,77,35,0,1
10/03/2013,CHU de Strasbourg(Hautepierre),Urgences chirurgicales pédiatriques,3,0,49,52,6,6,0
10/03/2013,CHU de Strasbourg(Hautepierre),Urgences Adulte HTP,0,23,86,109,48,0,0
10/03/2013,CHU de Strasbourg(Hautepierre),Urgences chirurgicales pédiatriques,14,0,55,69,5,5,0
10/03/2013,CHU de Strasbourg(Hautepierre),Gynéco-Obstétrique (HTP),0,0,27,27,7,0,1
10/03/2013,Clinique des 3 Frontières,UPATOU (Structure des urgences),0,5,34,39,3,0,0
10/03/2013,Clinique des Diaconesses,SOS Main,0,2,26,28,7,1,0
10/03/2013,Clinique Ste Odile (Strasbourg,UPATOU,0,2,82,84,1,5,0
10/03/2013,CMCO,GYNECO-OBSTETRIQUE,0,0,0,0,0,0,0
10/03/2013,SIHCUS/CMCO,GYNECOLOGIE ET OBSTETRIQUE - CMCO,0,0,0,0,0,0,0
9/03/2013,CCOM,CCOM Chirurgie,0,0,29,29,3,0,0
9/03/2013,CH de Colmar (CMC Le Parc),SAU Le Parc,12,0,40,52,3,0,1
9/03/2013,CH de Colmar (Louis Pasteur),SAU Pasteur,0,22,97,119,27,13,0
9/03/2013,CH de Guebwiller,UHTCD,0,4,37,41,2,1,0
9/03/2013,CH de Mulhouse ( Hasenrain),PEDIATRIE NEONATOLOGIE,8,0,19,27,5,2,0
9/03/2013,CH de Mulhouse (Emile Muller-Moenschberg,URGENCES,1,19,114,134,17,14,0
9/03/2013,CH de Saverne,PEDIATRIE,4,0,15,19,1,0,0
9/03/2013,CH de Saverne,S.A.U. (ADULTES),0,2,39,41,5,4,1
9/03/2013,CH de Sélestat,Acceuil des urgences,1,17,74,92,13,2,2
9/03/2013,CH de Thann,Urgences,0,5,43,48,1,2,2
9/03/2013,CH de Wissembourg,Urgences ,1,6,22,29,2,2,1
9/03/2013,CHU de Strasbourg (Hôp. Civil),Urgences Médico-Chirurgicales NHC,0,22,86,108,47,0,3
9/03/2013,CHU de Strasbourg(Hautepierre),Urgences Adulte HTP,1,11,92,104,32,0,2
9/03/2013,CHU de Strasbourg(Hautepierre),Urgences chirurgicales pédiatriques,15,0,43,58,8,8,0
9/03/2013,CHU de Strasbourg(Hautepierre),Gynéco-Obstétrique (HTP),0,0,32,32,15,0,0
9/03/2013,CHU de Strasbourg(Hautepierre),Urgences chirurgicales pédiatriques,4,0,55,59,6,5,0
9/03/2013,Clinique des 3 Frontières,UPATOU (Structure des urgences),1,1,47,49,3,0,2
9/03/2013,Clinique Ste Odile (Strasbourg,UPATOU,0,4,76,80,1,8,0
9/03/2013,CMCO,GYNECO-OBSTETRIQUE,0,0,0,0,0,0,0
9/03/2013,SIHCUS/CMCO,GYNECOLOGIE ET OBSTETRIQUE - CMCO,0,0,0,0,0,0,0
8/03/2013,CCOM,CCOM Chirurgie,0,0,21,21,3,0,0
8/03/2013,CH Altkirch,Upatou,0,3,35,38,3,1,1
8/03/2013,CH de Colmar (CMC Le Parc),SAU Le Parc,11,0,39,50,4,0,0
8/03/2013,CH de Colmar (Louis Pasteur),SAU Pasteur,0,24,107,131,25,13,3
8/03/2013,CH de Guebwiller,UHTCD,0,3,34,37,2,2,2
8/03/2013,CH de Mulhouse ( Hasenrain),PEDIATRIE NEONATOLOGIE,14,0,18,32,7,2,0
8/03/2013,CH de Mulhouse (Emile Muller-Moenschberg,URGENCES,1,19,106,126,14,13,1
8/03/2013,CH de Saverne,S.A.U. (ADULTES),0,10,50,60,15,5,0
8/03/2013,CH de Saverne,PEDIATRIE,2,0,14,16,1,1,0
8/03/2013,CH de Sélestat,Acceuil des urgences,1,8,80,89,14,3,2
8/03/2013,CH de Thann,Urgences,0,3,35,38,1,2,0
8/03/2013,CH de Wissembourg,Urgences ,1,6,15,22,3,1,0
8/03/2013,CHU de Strasbourg (Hôp. Civil),Urgences Médico-Chirurgicales NHC,0,21,78,99,51,2,3
8/03/2013,CHU de Strasbourg(Hautepierre),Urgences chirurgicales pédiatriques,0,0,35,35,3,3,0
8/03/2013,CHU de Strasbourg(Hautepierre),Urgences Adulte HTP,0,22,77,99,44,0,0
8/03/2013,CHU de Strasbourg(Hautepierre),Urgences chirurgicales pédiatriques,14,0,38,52,9,9,0
8/03/2013,CHU de Strasbourg(Hautepierre),Gynéco-Obstétrique (HTP),1,0,29,30,15,0,0
8/03/2013,Clinique des 3 Frontières,UPATOU (Structure des urgences),0,8,44,52,11,0,0
8/03/2013,Clinique des Diaconesses,SOS Main,0,0,31,31,7,1,0
8/03/2013,Clinique Ste Odile (Strasbourg,UPATOU,0,7,61,68,4,3,3
8/03/2013,CMCO,GYNECO-OBSTETRIQUE,0,0,0,0,0,0,0
8/03/2013,SIHCUS/CMCO,GYNECOLOGIE ET OBSTETRIQUE - CMCO,0,0,0,0,0,0,0
7/03/2013,CCOM,CCOM Chirurgie,0,1,22,23,2,0,0
7/03/2013,CH Altkirch,Upatou,0,5,33,38,5,1,0
7/03/2013,CH de Colmar (CMC Le Parc),SAU Le Parc,6,0,40,46,13,0,0
7/03/2013,CH de Colmar (Louis Pasteur),SAU Pasteur,0,21,123,144,24,11,1
7/03/2013,CH de Guebwiller,UHTCD,0,0,36,36,0,0,0
7/03/2013,CH de Mulhouse ( Hasenrain),PEDIATRIE NEONATOLOGIE,13,0,23,36,7,2,0
7/03/2013,CH de Mulhouse (Emile Muller-Moenschberg,URGENCES,1,15,107,123,7,14,6
7/03/2013,CH de Saverne,S.A.U. (ADULTES),0,6,36,42,7,3,3
7/03/2013,CH de Saverne,PEDIATRIE,2,0,23,25,5,0,0
7/03/2013,CH de Sélestat,Acceuil des urgences,0,25,66,91,19,2,3
7/03/2013,CH de Thann,Urgences,0,6,37,43,2,2,0
7/03/2013,CH de Wissembourg,Urgences ,0,7,24,31,3,4,1
7/03/2013,CHU de Strasbourg (Hôp. Civil),Urgences Médico-Chirurgicales NHC,0,22,74,96,44,0,1
7/03/2013,CHU de Strasbourg(Hautepierre),Urgences chirurgicales pédiatriques,5,0,45,50,8,8,0
7/03/2013,CHU de Strasbourg(Hautepierre),Gynéco-Obstétrique (HTP),0,0,28,28,10,0,0
7/03/2013,CHU de Strasbourg(Hautepierre),Urgences Adulte HTP,0,15,86,101,45,0,1
7/03/2013,CHU de Strasbourg(Hautepierre),Urgences chirurgicales pédiatriques,3,0,42,45,3,3,0
7/03/2013,Clinique des 3 Frontières,UPATOU (Structure des urgences),0,3,34,37,4,0,0
7/03/2013,Clinique des Diaconesses,SOS Main,0,1,38,39,12,0,0
7/03/2013,Clinique Ste Odile (Strasbourg,UPATOU,0,2,78,80,1,6,2
7/03/2013,CMCO,GYNECO-OBSTETRIQUE,0,0,0,0,0,0,0
7/03/2013,SIHCUS/CMCO,GYNECOLOGIE ET OBSTETRIQUE - CMCO,0,0,30,30,0,0,0
6/03/2013,CCOM,CCOM Chirurgie,0,2,27,29,3,0,0
6/03/2013,CH Altkirch,Upatou,0,8,34,42,4,3,1
6/03/2013,CH de Colmar (CMC Le Parc),SAU Le Parc,8,0,33,41,9,0,0
6/03/2013,CH de Colmar (Louis Pasteur),SAU Pasteur,0,25,98,123,23,14,0
6/03/2013,CH de Guebwiller,UHTCD,0,3,30,33,1,1,2
6/03/2013,CH de Mulhouse ( Hasenrain),PEDIATRIE NEONATOLOGIE,13,0,27,40,4,1,0
6/03/2013,CH de Mulhouse (Emile Muller-Moenschberg,URGENCES,1,20,109,130,13,12,1
6/03/2013,CH de Saverne,S.A.U. (ADULTES),0,14,33,47,10,8,0
6/03/2013,CH de Saverne,PEDIATRIE,4,0,16,20,1,0,0
6/03/2013,CH de Sélestat,Acceuil des urgences,1,11,52,64,9,4,2
6/03/2013,CH de Thann,Urgences,1,5,40,46,2,1,0
6/03/2013,CH de Wissembourg,Urgences ,0,6,24,30,3,1,1
6/03/2013,CHU de Strasbourg (Hôp. Civil),Urgences Médico-Chirurgicales NHC,0,21,58,79,42,0,0
6/03/2013,CHU de Strasbourg(Hautepierre),Gynéco-Obstétrique (HTP),0,0,28,28,11,0,0
6/03/2013,CHU de Strasbourg(Hautepierre),Urgences chirurgicales pédiatriques,2,0,37,39,0,0,0
6/03/2013,CHU de Strasbourg(Hautepierre),Urgences Adulte HTP,0,12,86,98,30,0,0
6/03/2013,CHU de Strasbourg(Hautepierre),Urgences chirurgicales pédiatriques,17,0,39,56,5,5,0
6/03/2013,Clinique des 3 Frontières,UPATOU (Structure des urgences),2,6,36,44,8,0,2
6/03/2013,Clinique Ste Odile (Strasbourg,UPATOU,0,5,66,71,2,5,1
6/03/2013,CMCO,GYNECO-OBSTETRIQUE,0,0,0,0,0,0,0
6/03/2013,SIHCUS/CMCO,GYNECOLOGIE ET OBSTETRIQUE - CMCO,0,0,0,0,0,0,0
5/03/2013,CCOM,CCOM Chirurgie,0,1,36,37,7,0,0
5/03/2013,CH Altkirch,Upatou,1,12,23,36,7,2,2
5/03/2013,CH de Colmar (CMC Le Parc),SAU Le Parc,8,0,28,36,7,0,0
5/03/2013,CH de Colmar (Louis Pasteur),SAU Pasteur,0,19,103,122,26,9,1
5/03/2013,CH de Guebwiller,UHTCD,0,4,34,38,1,0,1
5/03/2013,CH de Mulhouse ( Hasenrain),PEDIATRIE NEONATOLOGIE,9,0,32,41,7,2,0
5/03/2013,CH de Mulhouse (Emile Muller-Moenschberg,URGENCES,1,25,109,135,3,20,4
5/03/2013,CH de Saverne,S.A.U. (ADULTES),0,17,37,54,12,7,1
5/03/2013,CH de Saverne,PEDIATRIE,4,0,14,18,2,1,0
5/03/2013,CH de Sélestat,Acceuil des urgences,3,13,56,72,13,4,1
5/03/2013,CH de Thann,Urgences,0,5,33,38,2,2,0
5/03/2013,CH de Wissembourg,Urgences ,0,6,26,32,8,2,0
5/03/2013,CHU de Strasbourg (Hôp. Civil),Urgences Médico-Chirurgicales NHC,0,20,43,63,46,0,4
5/03/2013,CHU de Strasbourg(Hautepierre),Urgences chirurgicales pédiatriques,3,0,31,34,4,4,0
5/03/2013,CHU de Strasbourg(Hautepierre),Urgences Adulte HTP,0,20,82,102,41,0,0
5/03/2013,CHU de Strasbourg(Hautepierre),Urgences chirurgicales pédiatriques,12,0,49,61,13,13,0
5/03/2013,CHU de Strasbourg(Hautepierre),Gynéco-Obstétrique (HTP),0,0,27,27,14,0,0
5/03/2013,Clinique des 3 Frontières,UPATOU (Structure des urgences),0,3,39,42,3,0,0
5/03/2013,Clinique des Diaconesses,SOS Main,0,1,37,38,12,0,0
5/03/2013,Clinique Ste Odile (Strasbourg,UPATOU,0,5,66,71,2,6,6
5/03/2013,CMCO,GYNECO-OBSTETRIQUE,0,0,0,0,0,0,0
5/03/2013,SIHCUS/CMCO,GYNECOLOGIE ET OBSTETRIQUE - CMCO,0,0,0,0,0,0,0
4/03/2013,CCOM,CCOM Chirurgie,0,5,44,49,6,0,0
4/03/2013,CH Altkirch,Upatou,2,6,26,34,3,2,1
4/03/2013,CH de Colmar (CMC Le Parc),SAU Le Parc,13,0,29,42,7,1,0
4/03/2013,CH de Colmar (Louis Pasteur),SAU Pasteur,0,25,118,143,28,11,0
4/03/2013,CH de Guebwiller,UHTCD,0,8,39,47,2,3,1
4/03/2013,CH de Mulhouse ( Hasenrain),PEDIATRIE NEONATOLOGIE,13,0,19,32,7,2,0
4/03/2013,CH de Mulhouse (Emile Muller-Moenschberg,URGENCES,0,30,108,138,11,13,2
4/03/2013,CH de Saverne,S.A.U. (ADULTES),0,12,43,55,13,9,1
4/03/2013,CH de Saverne,PEDIATRIE,5,0,16,21,2,2,0
4/03/2013,CH de Sélestat,Acceuil des urgences,0,20,74,94,17,6,6
4/03/2013,CH de Thann,Urgences,0,7,29,36,3,5,0
4/03/2013,CH de Wissembourg,Urgences ,0,4,28,32,5,3,0
4/03/2013,CHU de Strasbourg (Hôp. Civil),Urgences Médico-Chirurgicales NHC,0,19,56,75,48,2,2
4/03/2013,CHU de Strasbourg(Hautepierre),Urgences chirurgicales pédiatriques,20,0,52,72,10,10,0
4/03/2013,CHU de Strasbourg(Hautepierre),Gynéco-Obstétrique (HTP),0,0,26,26,12,0,0
4/03/2013,CHU de Strasbourg(Hautepierre),Urgences chirurgicales pédiatriques,1,0,48,49,2,2,0
4/03/2013,CHU de Strasbourg(Hautepierre),Urgences Adulte HTP,0,23,66,89,32,0,0
4/03/2013,Clinique des 3 Frontières,UPATOU (Structure des urgences),1,6,47,54,5,0,1
4/03/2013,Clinique des Diaconesses,SOS Main,0,1,39,40,11,0,0
4/03/2013,Clinique Ste Odile (Strasbourg,UPATOU,0,4,68,72,0,7,0
4/03/2013,CMCO,GYNECO-OBSTETRIQUE,0,0,0,0,0,0,0
4/03/2013,SIHCUS/CMCO,GYNECOLOGIE ET OBSTETRIQUE - CMCO,0,0,0,0,0,0,0
3/03/2013,CCOM,CCOM Chirurgie,0,0,17,17,2,0,0
3/03/2013,CH Altkirch,Upatou,0,9,43,52,6,0,1
3/03/2013,CH de Colmar (CMC Le Parc),SAU Le Parc,4,0,61,65,14,0,0
3/03/2013,CH de Colmar (Louis Pasteur),SAU Pasteur,0,17,113,130,15,12,0
3/03/2013,CH de Guebwiller,UHTCD,0,4,41,45,1,3,1
3/03/2013,CH de Mulhouse ( Hasenrain),PEDIATRIE NEONATOLOGIE,22,0,19,41,4,0,0
3/03/2013,CH de Mulhouse (Emile Muller-Moenschberg,URGENCES,1,23,115,139,11,14,1
3/03/2013,CH de Saverne,S.A.U. (ADULTES),0,5,42,47,13,4,1
3/03/2013,CH de Saverne,PEDIATRIE,2,0,14,16,3,0,0
3/03/2013,CH de Sélestat,Acceuil des urgences,1,8,79,88,11,6,1
3/03/2013,CH de Thann,Urgences,0,5,44,49,1,4,3
3/03/2013,CH de Wissembourg,Urgences ,1,6,31,38,5,2,1
3/03/2013,CHU de Strasbourg (Hôp. Civil),Urgences Médico-Chirurgicales NHC,0,16,89,105,34,2,0
3/03/2013,CHU de Strasbourg(Hautepierre),Urgences chirurgicales pédiatriques,20,0,48,68,13,11,0
3/03/2013,CHU de Strasbourg(Hautepierre),Gynéco-Obstétrique (HTP),0,0,27,27,9,0,0
3/03/2013,CHU de Strasbourg(Hautepierre),Urgences chirurgicales pédiatriques,4,0,43,47,5,5,0
3/03/2013,CHU de Strasbourg(Hautepierre),Urgences Adulte HTP,0,15,98,113,40,0,0
3/03/2013,Clinique des 3 Frontières,UPATOU (Structure des urgences),4,2,44,50,2,0,0
3/03/2013,Clinique des Diaconesses,SOS Main,0,3,24,27,1,0,0
3/03/2013,Clinique Ste Odile (Strasbourg,UPATOU,0,0,76,76,1,9,3
3/03/2013,CMCO,GYNECO-OBSTETRIQUE,0,0,0,0,0,0,0
3/03/2013,SIHCUS/CMCO,GYNECOLOGIE ET OBSTETRIQUE - CMCO,0,0,0,0,0,0,0
2/03/2013,CCOM,CCOM Chirurgie,0,0,16,16,1,0,0
2/03/2013,CCOM,CCOM Chirurgie,0,0,16,16,1,0,0
2/03/2013,CH Altkirch,Upatou,0,4,41,45,3,2,3
2/03/2013,CH de Colmar (CMC Le Parc),SAU Le Parc,9,0,43,52,6,0,0
2/03/2013,CH de Colmar (Louis Pasteur),SAU Pasteur,0,22,109,131,32,7,2
2/03/2013,CH de Guebwiller,UHTCD,0,7,40,47,3,1,5
2/03/2013,CH de Mulhouse ( Hasenrain),PEDIATRIE NEONATOLOGIE,16,0,29,45,2,1,0
2/03/2013,CH de Mulhouse (Emile Muller-Moenschberg,URGENCES,2,24,106,132,12,9,5
2/03/2013,CH de Saverne,PEDIATRIE,2,0,22,24,5,1,0
2/03/2013,CH de Saverne,S.A.U. (ADULTES),0,11,32,43,6,5,0
2/03/2013,CH de Sélestat,Acceuil des urgences,0,17,61,78,16,4,1
2/03/2013,CH de Thann,Urgences,0,7,37,44,3,0,1
2/03/2013,CHU de Strasbourg (Hôp. Civil),Urgences Médico-Chirurgicales NHC,1,18,76,95,42,4,0
2/03/2013,CHU de Strasbourg(Hautepierre),Urgences chirurgicales pédiatriques,2,0,32,34,2,2,0
2/03/2013,CHU de Strasbourg(Hautepierre),Urgences Adulte HTP,0,20,89,109,30,0,0
2/03/2013,CHU de Strasbourg(Hautepierre),Urgences chirurgicales pédiatriques,18,0,51,69,7,7,0
2/03/2013,CHU de Strasbourg(Hautepierre),Gynéco-Obstétrique (HTP),1,0,31,32,7,0,0
2/03/2013,Clinique des 3 Frontières,UPATOU (Structure des urgences),0,2,38,40,7,0,0
2/03/2013,Clinique des Diaconesses,SOS Main,0,2,34,36,0,0,1
2/03/2013,Clinique Ste Odile (Strasbourg,UPATOU,0,6,58,64,3,13,1
2/03/2013,CMCO,GYNECO-OBSTETRIQUE,0,0,0,0,0,0,0
2/03/2013,SIHCUS/CMCO,GYNECOLOGIE ET OBSTETRIQUE - CMCO,0,0,0,0,0,0,0
1/03/2013,CCOM,CCOM Chirurgie,0,2,11,13,0,0,0
1/03/2013,CH Altkirch,Upatou,1,5,26,32,3,1,2
1/03/2013,CH de Colmar (CMC Le Parc),SAU Le Parc,9,0,25,34,0,0,0
1/03/2013,CH de Colmar (Louis Pasteur),SAU Pasteur,0,22,105,127,27,13,1
1/03/2013,CH de Guebwiller,UHTCD,0,5,40,45,3,3,2
1/03/2013,CH de Mulhouse ( Hasenrain),PEDIATRIE NEONATOLOGIE,12,0,20,32,5,1,0
1/03/2013,CH de Mulhouse (Emile Muller-Moenschberg,URGENCES,0,27,82,109,22,8,3
1/03/2013,CH de Saverne,S.A.U. (ADULTES),0,11,33,44,8,6,1
1/03/2013,CH de Saverne,PEDIATRIE,4,0,13,17,4,1,0
1/03/2013,CH de Sélestat,Acceuil des urgences,2,13,56,71,12,6,1
1/03/2013,CH de Thann,Urgences,1,11,21,33,4,2,3
1/03/2013,CH de Wissembourg,Urgences ,2,6,27,35,11,0,0
1/03/2013,CHU de Strasbourg (Hôp. Civil),Urgences Médico-Chirurgicales NHC,0,24,72,96,51,9,0
1/03/2013,CHU de Strasbourg(Hautepierre),Urgences chirurgicales pédiatriques,17,0,45,62,7,7,0
1/03/2013,CHU de Strasbourg(Hautepierre),Gynéco-Obstétrique (HTP),0,0,32,32,17,0,0
1/03/2013,CHU de Strasbourg(Hautepierre),Urgences Adulte HTP,0,29,77,106,43,0,0
1/03/2013,CHU de Strasbourg(Hautepierre),Urgences chirurgicales pédiatriques,4,0,33,37,4,4,0
1/03/2013,Clinique des 3 Frontières,UPATOU (Structure des urgences),1,6,39,46,6,0,1
1/03/2013,Clinique des Diaconesses,SOS Main,0,2,25,27,0,0,0
1/03/2013,Clinique Ste Odile (Strasbourg,UPATOU,0,3,57,60,1,7,1
1/03/2013,CMCO,GYNECO-OBSTETRIQUE,0,0,0,0,0,0,0
1/03/2013,SIHCUS/CMCO,GYNECOLOGIE ET OBSTETRIQUE - CMCO,0,0,0,0,0,0,0
1/05/2013,CCOM,CCOM Chirurgie,0,1,16,17,3,0,0
1/05/2013,CH Altkirch,Upatou,0,5,29,34,6,1,2
1/05/2013,CH de Colmar (CMC Le Parc),SAU Le Parc,4,0,38,42,5,1,0
1/05/2013,CH de Colmar (Louis Pasteur),SAU Pasteur,1,17,96,114,23,9,0
1/05/2013,CH de Guebwiller,UHTCD,0,1,41,42,0,2,2
1/05/2013,CH de Mulhouse ( Hasenrain),PEDIATRIE NEONATOLOGIE,8,0,14,22,3,1,0
1/05/2013,CH de Mulhouse (Emile Muller-Moenschberg,URGENCES,0,14,97,111,12,12,1
1/05/2013,CH de Saverne,S.A.U. (ADULTES),0,3,32,35,6,3,0
1/05/2013,CH de Saverne,PEDIATRIE,3,0,18,21,0,1,0
1/05/2013,CH de Sélestat,Acceuil des urgences,0,9,76,85,15,4,1
1/05/2013,CH de Thann,Urgences,2,4,44,50,1,1,3
1/05/2013,CH de Wissembourg,Urgences ,2,9,18,29,6,2,0
1/05/2013,CHU de Strasbourg (Hôp. Civil),Urgences Médico-Chirurgicales NHC,0,16,90,106,40,6,2
1/05/2013,CHU de Strasbourg(Hautepierre),Urgences Adulte HTP,0,14,71,85,28,0,0
1/05/2013,CHU de Strasbourg(Hautepierre),Urgences chirurgicales pédiatriques,7,0,34,41,3,3,0
1/05/2013,CHU de Strasbourg(Hautepierre),Urgences chirurgicales pédiatriques,3,0,39,42,3,3,0
1/05/2013,CHU de Strasbourg(Hautepierre),Gynéco-Obstétrique (HTP),0,0,26,26,10,0,0
1/05/2013,Clinique des 3 Frontières,UPATOU (Structure des urgences),0,3,50,53,3,1,1
1/05/2013,Clinique Ste Odile (Strasbourg,UPATOU,0,4,69,73,4,8,5
1/05/2013,CMCO,GYNECO-OBSTETRIQUE,0,0,0,0,0,0,0
1/05/2013,SIHCUS/CMCO,GYNECOLOGIE ET OBSTETRIQUE - CMCO,0,0,0,0,0,0,0
30/04/2013,CCOM,CCOM Chirurgie,0,0,20,20,2,0,0
30/04/2013,CH Altkirch,Upatou,0,5,27,32,5,1,0
30/04/2013,CH de Colmar (CMC Le Parc),SAU Le Parc,5,0,37,42,5,0,0
30/04/2013,CH de Colmar (Louis Pasteur),SAU Pasteur,0,28,98,126,25,8,0
30/04/2013,CH de Guebwiller,UHTCD,0,5,42,47,5,3,4
30/04/2013,CH de Mulhouse ( Hasenrain),PEDIATRIE NEONATOLOGIE,6,0,22,28,4,0,0
30/04/2013,CH de Mulhouse (Emile Muller-Moenschberg,URGENCES,2,23,105,130,9,14,2
30/04/2013,CH de Saverne,S.A.U. (ADULTES),0,13,32,45,11,3,0
30/04/2013,CH de Saverne,PEDIATRIE,4,0,8,12,1,0,0
30/04/2013,CH de Sélestat,Acceuil des urgences,0,10,59,69,11,3,2
30/04/2013,CH de Thann,Urgences,0,11,37,48,1,0,1
30/04/2013,CH de Wissembourg,Urgences ,0,4,32,36,6,0,1
30/04/2013,CHU de Strasbourg (Hôp. Civil),Urgences Médico-Chirurgicales NHC,0,16,70,86,43,1,2
30/04/2013,CHU de Strasbourg(Hautepierre),Urgences chirurgicales pédiatriques,1,0,38,39,2,2,0
30/04/2013,CHU de Strasbourg(Hautepierre),Urgences chirurgicales pédiatriques,9,0,35,44,8,8,0
30/04/2013,CHU de Strasbourg(Hautepierre),Gynéco-Obstétrique (HTP),1,0,31,32,13,0,0
30/04/2013,CHU de Strasbourg(Hautepierre),Urgences Adulte HTP,0,20,79,99,44,0,1
30/04/2013,Clinique des 3 Frontières,UPATOU (Structure des urgences),1,3,34,38,5,0,0
30/04/2013,Clinique des Diaconesses,SOS Main,0,1,28,29,0,0,0
30/04/2013,Clinique Ste Odile (Strasbourg,UPATOU,0,3,81,84,1,7,3
30/04/2013,CMCO,GYNECO-OBSTETRIQUE,0,0,0,0,0,0,0
30/04/2013,SIHCUS/CMCO,GYNECOLOGIE ET OBSTETRIQUE - CMCO,0,0,0,0,0,0,0
29/04/2013,CCOM,CCOM Chirurgie,0,1,19,20,2,0,0
29/04/2013,CH Altkirch,Upatou,0,8,32,40,0,2,3
29/04/2013,CH de Colmar (CMC Le Parc),SAU Le Parc,5,0,41,46,6,0,0
29/04/2013,CH de Colmar (Louis Pasteur),SAU Pasteur,0,23,129,152,21,12,0
29/04/2013,CH de Guebwiller,UHTCD,0,3,36,39,1,4,1
29/04/2013,CH de Mulhouse ( Hasenrain),PEDIATRIE NEONATOLOGIE,8,0,33,41,5,0,0
29/04/2013,CH de Mulhouse (Emile Muller-Moenschberg,URGENCES,0,16,124,140,12,14,2
29/04/2013,CH de Saverne,PEDIATRIE,5,0,15,20,1,1,0
29/04/2013,CH de Saverne,S.A.U. (ADULTES),0,17,40,57,10,3,1
29/04/2013,CH de Sélestat,Acceuil des urgences,0,12,77,89,12,6,5
29/04/2013,CH de Thann,Urgences,0,6,35,41,2,2,1
29/04/2013,CH de Wissembourg,Urgences ,1,6,30,37,7,2,0
29/04/2013,CHU de Strasbourg (Hôp. Civil),Urgences Médico-Chirurgicales NHC,0,14,72,86,44,1,3
29/04/2013,CHU de Strasbourg(Hautepierre),Urgences chirurgicales pédiatriques,2,0,46,48,5,5,0
29/04/2013,CHU de Strasbourg(Hautepierre),Urgences chirurgicales pédiatriques,13,0,40,53,11,10,0
29/04/2013,CHU de Strasbourg(Hautepierre),Gynéco-Obstétrique (HTP),0,0,22,22,8,0,0
29/04/2013,CHU de Strasbourg(Hautepierre),Urgences Adulte HTP,0,11,77,88,41,0,1
29/04/2013,Clinique des 3 Frontières,UPATOU (Structure des urgences),0,6,43,49,6,0,0
29/04/2013,Clinique des Diaconesses,SOS Main,0,0,36,36,0,0,0
29/04/2013,Clinique Ste Odile (Strasbourg,UPATOU,0,6,67,73,3,7,1
29/04/2013,CMCO,GYNECO-OBSTETRIQUE,0,0,0,0,0,0,0
29/04/2013,SIHCUS/CMCO,GYNECOLOGIE ET OBSTETRIQUE - CMCO,0,0,0,0,0,0,0
28/04/2013,CCOM,CCOM Chirurgie,0,0,13,13,4,0,0
28/04/2013,CH Altkirch,Upatou,0,7,38,45,4,1,5
28/04/2013,CH de Colmar (CMC Le Parc),SAU Le Parc,13,0,38,51,14,0,0
28/04/2013,CH de Colmar (Louis Pasteur),SAU Pasteur,0,18,117,135,16,12,0
28/04/2013,CH de Guebwiller,UHTCD,0,4,45,49,0,3,0
28/04/2013,CH de Mulhouse ( Hasenrain),PEDIATRIE NEONATOLOGIE,14,0,26,40,6,1,0
28/04/2013,CH de Mulhouse (Emile Muller-Moenschberg,URGENCES,0,21,111,132,15,8,1
28/04/2013,CH de Saverne,PEDIATRIE,5,0,11,16,2,0,0
28/04/2013,CH de Saverne,S.A.U. (ADULTES),0,8,30,38,10,5,0
28/04/2013,CH de Sélestat,Acceuil des urgences,4,6,72,82,9,3,0
28/04/2013,CH de Thann,Urgences,0,3,25,28,2,0,0
28/04/2013,CHU de Strasbourg (Hôp. Civil),Urgences Médico-Chirurgicales NHC,0,10,84,94,35,5,2
28/04/2013,CHU de Strasbourg(Hautepierre),Urgences Adulte HTP,0,17,87,104,32,0,0
28/04/2013,CHU de Strasbourg(Hautepierre),Urgences chirurgicales pédiatriques,15,0,40,55,12,12,0
28/04/2013,CHU de Strasbourg(Hautepierre),Gynéco-Obstétrique (HTP),0,0,28,28,8,0,0
28/04/2013,CHU de Strasbourg(Hautepierre),Urgences chirurgicales pédiatriques,4,0,38,42,5,4,0
28/04/2013,Clinique des 3 Frontières,UPATOU (Structure des urgences),0,11,42,53,8,1,1
28/04/2013,Clinique des Diaconesses,SOS Main,0,2,28,30,0,0,0
28/04/2013,Clinique Ste Odile (Strasbourg,UPATOU,0,1,76,77,2,5,3
28/04/2013,CMCO,GYNECO-OBSTETRIQUE,0,0,0,0,0,0,0
28/04/2013,SIHCUS/CMCO,GYNECOLOGIE ET OBSTETRIQUE - CMCO,0,0,0,0,0,0,0
27/04/2013,CCOM,CCOM Chirurgie,0,0,24,24,4,0,0
27/04/2013,CH Altkirch,Upatou,0,3,36,39,3,0,8
27/04/2013,CH de Colmar (CMC Le Parc),SAU Le Parc,9,0,36,45,6,0,0
27/04/2013,CH de Colmar (Louis Pasteur),SAU Pasteur,0,16,111,127,18,12,4
27/04/2013,CH de Guebwiller,UHTCD,0,0,34,34,1,2,6
27/04/2013,CH de Mulhouse ( Hasenrain),PEDIATRIE NEONATOLOGIE,11,0,17,28,3,0,0
27/04/2013,CH de Mulhouse (Emile Muller-Moenschberg,URGENCES,0,18,107,125,20,7,5
27/04/2013,CH de Saverne,PEDIATRIE,3,0,16,19,0,0,0
27/04/2013,CH de Saverne,S.A.U. (ADULTES),0,9,46,55,3,5,2
27/04/2013,CH de Sélestat,Acceuil des urgences,1,6,63,70,7,4,0
27/04/2013,CH de Thann,Urgences,0,6,35,41,0,2,2
27/04/2013,CHU de Strasbourg (Hôp. Civil),Urgences Médico-Chirurgicales NHC,0,12,82,94,36,1,0
27/04/2013,CHU de Strasbourg(Hautepierre),Urgences chirurgicales pédiatriques,8,0,35,43,5,4,0
27/04/2013,CHU de Strasbourg(Hautepierre),Gynéco-Obstétrique (HTP),1,0,27,28,7,0,0
27/04/2013,CHU de Strasbourg(Hautepierre),Urgences Adulte HTP,0,11,70,81,21,0,0
27/04/2013,CHU de Strasbourg(Hautepierre),Urgences chirurgicales pédiatriques,4,0,43,47,2,2,0
27/04/2013,Clinique des 3 Frontières,UPATOU (Structure des urgences),0,1,44,45,3,0,0
27/04/2013,Clinique des Diaconesses,SOS Main,0,0,28,28,0,0,0
27/04/2013,Clinique Ste Odile (Strasbourg,UPATOU,0,7,64,71,0,3,5
27/04/2013,CMCO,GYNECO-OBSTETRIQUE,0,0,0,0,0,0,0
27/04/2013,SIHCUS/CMCO,GYNECOLOGIE ET OBSTETRIQUE - CMCO,0,0,0,0,0,0,0
26/04/2013,CCOM,CCOM Chirurgie,0,1,24,25,0,0,0
26/04/2013,CH Altkirch,Upatou,1,7,35,43,8,3,0
26/04/2013,CH de Colmar (CMC Le Parc),SAU Le Parc,7,0,30,37,7,0,0
26/04/2013,CH de Colmar (Louis Pasteur),SAU Pasteur,0,34,103,137,28,15,2
26/04/2013,CH de Guebwiller,UHTCD,0,3,39,42,3,2,3
26/04/2013,CH de Mulhouse ( Hasenrain),PEDIATRIE NEONATOLOGIE,11,0,18,29,6,2,0
26/04/2013,CH de Mulhouse (Emile Muller-Moenschberg,URGENCES,0,24,97,121,10,19,2
26/04/2013,CH de Saverne,S.A.U. (ADULTES),0,10,41,51,15,5,0
26/04/2013,CH de Saverne,PEDIATRIE,7,0,17,24,1,0,0
26/04/2013,CH de Sélestat,Acceuil des urgences,1,8,56,65,9,3,3
26/04/2013,CH de Thann,Urgences,0,5,22,27,1,1,0
26/04/2013,CHU de Strasbourg (Hôp. Civil),Urgences Médico-Chirurgicales NHC,0,17,70,87,44,5,0
26/04/2013,CHU de Strasbourg(Hautepierre),Urgences chirurgicales pédiatriques,18,0,46,64,10,10,0
26/04/2013,CHU de Strasbourg(Hautepierre),Gynéco-Obstétrique (HTP),1,0,28,29,16,0,0
26/04/2013,CHU de Strasbourg(Hautepierre),Urgences Adulte HTP,0,22,83,105,35,0,0
26/04/2013,CHU de Strasbourg(Hautepierre),Urgences chirurgicales pédiatriques,2,0,39,41,2,1,0
26/04/2013,Clinique des 3 Frontières,UPATOU (Structure des urgences),1,5,42,48,3,0,0
26/04/2013,Clinique des Diaconesses,SOS Main,0,4,24,28,1,0,0
26/04/2013,Clinique Ste Odile (Strasbourg,UPATOU,0,3,76,79,4,12,2
26/04/2013,CMCO,GYNECO-OBSTETRIQUE,0,0,0,0,0,0,0
26/04/2013,SIHCUS/CMCO,GYNECOLOGIE ET OBSTETRIQUE - CMCO,0,0,0,0,0,0,0
25/04/2013,CCOM,CCOM Chirurgie,0,0,22,22,1,0,0
25/04/2013,CH Altkirch,Upatou,0,7,45,52,5,3,0
25/04/2013,CH de Colmar (CMC Le Parc),SAU Le Parc,4,0,36,40,7,0,0
25/04/2013,CH de Colmar (Louis Pasteur),SAU Pasteur,0,24,91,115,24,9,1
25/04/2013,CH de Guebwiller,UHTCD,0,2,39,41,0,0,2
25/04/2013,CH de Mulhouse ( Hasenrain),PEDIATRIE NEONATOLOGIE,6,0,28,34,4,2,0
25/04/2013,CH de Mulhouse (Emile Muller-Moenschberg,URGENCES,0,27,116,143,19,7,4
25/04/2013,CH de Saverne,PEDIATRIE,7,0,20,27,2,1,0
25/04/2013,CH de Saverne,S.A.U. (ADULTES),0,9,49,58,8,3,0
25/04/2013,CH de Sélestat,Acceuil des urgences,1,9,60,70,11,3,1
25/04/2013,CH de Thann,Urgences,0,6,34,40,3,1,2
25/04/2013,CH de Wissembourg,Urgences ,1,7,23,31,5,1,1
25/04/2013,CHU de Strasbourg (Hôp. Civil),Urgences Médico-Chirurgicales NHC,0,23,66,89,45,9,3
25/04/2013,CHU de Strasbourg(Hautepierre),Urgences chirurgicales pédiatriques,2,0,40,42,6,6,0
25/04/2013,CHU de Strasbourg(Hautepierre),Urgences chirurgicales pédiatriques,13,0,31,44,9,8,0
25/04/2013,CHU de Strasbourg(Hautepierre),Gynéco-Obstétrique (HTP),1,0,32,33,18,0,0
25/04/2013,CHU de Strasbourg(Hautepierre),Urgences Adulte HTP,0,22,82,104,38,0,0
25/04/2013,Clinique des 3 Frontières,UPATOU (Structure des urgences),1,4,35,40,3,0,1
25/04/2013,Clinique des Diaconesses,SOS Main,0,2,27,29,12,1,0
25/04/2013,Clinique Ste Odile (Strasbourg,UPATOU,0,4,65,69,1,4,1
25/04/2013,CMCO,GYNECO-OBSTETRIQUE,0,0,0,0,0,0,0
25/04/2013,SIHCUS/CMCO,GYNECOLOGIE ET OBSTETRIQUE - CMCO,0,0,0,0,0,0,0
24/04/2013,CCOM,CCOM Chirurgie,0,1,25,26,2,0,0
24/04/2013,CH Altkirch,Upatou,0,2,24,26,4,1,2
24/04/2013,CH de Colmar (CMC Le Parc),SAU Le Parc,7,0,46,53,9,0,0
24/04/2013,CH de Colmar (Louis Pasteur),SAU Pasteur,1,26,96,123,22,13,2
24/04/2013,CH de Guebwiller,UHTCD,1,7,37,45,2,1,1
24/04/2013,CH de Mulhouse ( Hasenrain),PEDIATRIE NEONATOLOGIE,16,0,20,36,5,0,0
24/04/2013,CH de Mulhouse (Emile Muller-Moenschberg,URGENCES,0,19,111,130,7,15,1
24/04/2013,CH de Saverne,PEDIATRIE,6,0,19,25,7,1,0
24/04/2013,CH de Saverne,S.A.U. (ADULTES),0,7,41,48,8,5,2
24/04/2013,CH de Sélestat,Acceuil des urgences,0,14,66,80,18,5,3
24/04/2013,CH de Thann,Urgences,1,8,49,58,5,1,0
24/04/2013,CH de Wissembourg,Urgences ,2,3,18,23,5,0,0
24/04/2013,CHU de Strasbourg (Hôp. Civil),Urgences Médico-Chirurgicales NHC,0,18,64,82,37,7,2
24/04/2013,CHU de Strasbourg(Hautepierre),Urgences chirurgicales pédiatriques,16,0,39,55,5,5,0
24/04/2013,CHU de Strasbourg(Hautepierre),Gynéco-Obstétrique (HTP),0,0,20,20,11,0,0
24/04/2013,CHU de Strasbourg(Hautepierre),Urgences Adulte HTP,0,18,76,94,25,0,2
24/04/2013,CHU de Strasbourg(Hautepierre),Urgences chirurgicales pédiatriques,3,0,55,58,2,2,0
24/04/2013,Clinique des 3 Frontières,UPATOU (Structure des urgences),0,2,50,52,7,0,0
24/04/2013,Clinique des Diaconesses,SOS Main,0,1,28,29,13,1,0
24/04/2013,Clinique Ste Odile (Strasbourg,UPATOU,0,7,59,66,0,8,1
24/04/2013,CMCO,GYNECO-OBSTETRIQUE,0,0,0,0,0,0,0
24/04/2013,SIHCUS/CMCO,GYNECOLOGIE ET OBSTETRIQUE - CMCO,0,0,0,0,0,0,0
23/04/2013,CCOM,CCOM Chirurgie,0,1,24,25,0,0,0
23/04/2013,CH Altkirch,Upatou,0,5,31,36,3,2,2
23/04/2013,CH de Colmar (CMC Le Parc),SAU Le Parc,10,0,30,40,4,0,0
23/04/2013,CH de Colmar (Louis Pasteur),SAU Pasteur,1,28,102,131,19,10,1
23/04/2013,CH de Guebwiller,UHTCD,0,6,32,38,1,2,4
23/04/2013,CH de Mulhouse ( Hasenrain),PEDIATRIE NEONATOLOGIE,7,0,21,28,3,1,0
23/04/2013,CH de Mulhouse (Emile Muller-Moenschberg,URGENCES,1,29,113,143,21,12,3
23/04/2013,CH de Saverne,PEDIATRIE,2,0,12,14,2,0,0
23/04/2013,CH de Saverne,S.A.U. (ADULTES),0,6,28,34,9,5,1
23/04/2013,CH de Sélestat,Acceuil des urgences,0,18,71,89,14,6,1
23/04/2013,CH de Thann,Urgences,0,4,23,27,3,0,1
23/04/2013,CH de Wissembourg,Urgences ,0,7,20,27,4,2,0
23/04/2013,CHU de Strasbourg (Hôp. Civil),Urgences Médico-Chirurgicales NHC,0,14,65,79,42,0,2
23/04/2013,CHU de Strasbourg(Hautepierre),Urgences chirurgicales pédiatriques,4,0,44,48,8,8,0
23/04/2013,CHU de Strasbourg(Hautepierre),Urgences Adulte HTP,0,22,80,102,47,0,0
23/04/2013,CHU de Strasbourg(Hautepierre),Urgences chirurgicales pédiatriques,15,0,34,49,12,11,0
23/04/2013,CHU de Strasbourg(Hautepierre),Gynéco-Obstétrique (HTP),2,0,24,26,13,0,0
23/04/2013,Clinique des 3 Frontières,UPATOU (Structure des urgences),0,4,31,35,6,0,2
23/04/2013,Clinique des Diaconesses,SOS Main,0,4,48,52,21,0,0
23/04/2013,Clinique Ste Odile (Strasbourg,UPATOU,0,4,60,64,2,7,0
23/04/2013,CMCO,GYNECO-OBSTETRIQUE,0,0,0,0,0,0,0
23/04/2013,SIHCUS/CMCO,GYNECOLOGIE ET OBSTETRIQUE - CMCO,0,0,0,0,0,0,0
22/04/2013,CCOM,CCOM Chirurgie,0,0,30,30,3,0,0
22/04/2013,CH Altkirch,Upatou,0,7,26,33,5,0,0
22/04/2013,CH de Colmar (CMC Le Parc),SAU Le Parc,12,0,34,46,5,0,0
22/04/2013,CH de Colmar (Louis Pasteur),SAU Pasteur,0,24,109,133,21,8,0
22/04/2013,CH de Guebwiller,UHTCD,0,3,40,43,1,0,2
22/04/2013,CH de Mulhouse ( Hasenrain),PEDIATRIE NEONATOLOGIE,13,0,20,33,7,0,0
22/04/2013,CH de Mulhouse (Emile Muller-Moenschberg,URGENCES,0,20,99,119,21,12,1
22/04/2013,CH de Saverne,PEDIATRIE,5,0,13,18,2,0,0
22/04/2013,CH de Saverne,S.A.U. (ADULTES),0,7,47,54,10,7,0
22/04/2013,CH de Sélestat,Acceuil des urgences,1,17,68,86,21,5,2
22/04/2013,CH de Thann,Urgences,0,4,43,47,2,1,1
22/04/2013,CH de Wissembourg,Urgences ,0,12,35,47,12,1,0
22/04/2013,CHU de Strasbourg (Hôp. Civil),Urgences Médico-Chirurgicales NHC,0,13,57,70,40,0,0
22/04/2013,CHU de Strasbourg(Hautepierre),Urgences Adulte HTP,1,25,82,108,49,0,1
22/04/2013,CHU de Strasbourg(Hautepierre),Urgences chirurgicales pédiatriques,15,0,35,50,10,8,0
22/04/2013,CHU de Strasbourg(Hautepierre),Gynéco-Obstétrique (HTP),0,0,30,30,16,0,0
22/04/2013,CHU de Strasbourg(Hautepierre),Urgences chirurgicales pédiatriques,3,0,52,55,3,3,0
22/04/2013,Clinique des 3 Frontières,UPATOU (Structure des urgences),1,4,41,46,4,0,0
22/04/2013,Clinique des Diaconesses,SOS Main,0,2,42,44,2,0,0
22/04/2013,Clinique Ste Odile (Strasbourg,UPATOU,1,7,58,66,2,7,4
22/04/2013,CMCO,GYNECO-OBSTETRIQUE,0,0,0,0,0,0,0
22/04/2013,SIHCUS/CMCO,GYNECOLOGIE ET OBSTETRIQUE - CMCO,0,0,0,0,0,0,0
21/04/2013,CCOM,CCOM Chirurgie,0,1,14,15,3,0,0
21/04/2013,CH Altkirch,Upatou,0,6,35,41,5,2,0
21/04/2013,CH de Colmar (CMC Le Parc),SAU Le Parc,12,0,43,55,4,0,0
21/04/2013,CH de Colmar (Louis Pasteur),SAU Pasteur,0,26,112,138,17,9,0
21/04/2013,CH de Guebwiller,UHTCD,0,4,32,36,2,1,1
21/04/2013,CH de Mulhouse ( Hasenrain),PEDIATRIE NEONATOLOGIE,18,0,24,42,5,2,0
21/04/2013,CH de Mulhouse (Emile Muller-Moenschberg,URGENCES,1,16,98,115,16,11,4
21/04/2013,CH de Saverne,PEDIATRIE,2,0,22,24,1,1,0
21/04/2013,CH de Saverne,S.A.U. (ADULTES),0,10,45,55,9,4,1
21/04/2013,CH de Sélestat,Acceuil des urgences,1,4,72,77,11,4,1
21/04/2013,CH de Thann,Urgences,0,5,34,39,6,1,0
21/04/2013,CHU de Strasbourg (Hôp. Civil),Urgences Médico-Chirurgicales NHC,1,25,82,108,42,0,3
21/04/2013,CHU de Strasbourg(Hautepierre),Urgences chirurgicales pédiatriques,2,0,41,43,10,9,0
21/04/2013,CHU de Strasbourg(Hautepierre),Urgences Adulte HTP,0,7,92,99,24,0,0
21/04/2013,CHU de Strasbourg(Hautepierre),Urgences chirurgicales pédiatriques,13,0,44,57,7,5,0
21/04/2013,CHU de Strasbourg(Hautepierre),Gynéco-Obstétrique (HTP),0,0,34,34,8,0,0
21/04/2013,Clinique des 3 Frontières,UPATOU (Structure des urgences),0,5,48,53,5,0,0
21/04/2013,Clinique des Diaconesses,SOS Main,0,0,13,13,0,0,0
21/04/2013,Clinique Ste Odile (Strasbourg,UPATOU,0,3,67,70,2,6,1
21/04/2013,CMCO,GYNECO-OBSTETRIQUE,0,0,0,0,0,0,0
21/04/2013,SIHCUS/CMCO,GYNECOLOGIE ET OBSTETRIQUE - CMCO,0,0,0,0,0,0,0
20/04/2013,CCOM,CCOM Chirurgie,0,1,26,27,2,0,0
20/04/2013,CH Altkirch,Upatou,0,5,30,35,3,1,0
20/04/2013,CH de Colmar (CMC Le Parc),SAU Le Parc,13,0,43,56,10,0,0
20/04/2013,CH de Colmar (Louis Pasteur),SAU Pasteur,0,21,95,116,21,10,2
20/04/2013,CH de Guebwiller,UHTCD,1,4,39,44,2,0,1
20/04/2013,CH de Mulhouse ( Hasenrain),PEDIATRIE NEONATOLOGIE,14,0,21,35,2,0,1
20/04/2013,CH de Mulhouse (Emile Muller-Moenschberg,URGENCES,0,19,119,138,15,10,1
20/04/2013,CH de Saverne,PEDIATRIE,7,0,17,24,3,0,0
20/04/2013,CH de Saverne,S.A.U. (ADULTES),0,7,44,51,16,1,1
20/04/2013,CH de Sélestat,Acceuil des urgences,2,9,68,79,17,4,0
20/04/2013,CH de Thann,Urgences,1,7,41,49,2,2,3
20/04/2013,CHU de Strasbourg (Hôp. Civil),Urgences Médico-Chirurgicales NHC,1,20,96,117,44,2,2
20/04/2013,CHU de Strasbourg(Hautepierre),Urgences chirurgicales pédiatriques,5,0,49,54,9,8,0
20/04/2013,CHU de Strasbourg(Hautepierre),Urgences chirurgicales pédiatriques,18,0,41,59,5,4,0
20/04/2013,CHU de Strasbourg(Hautepierre),Gynéco-Obstétrique (HTP),0,0,25,25,8,0,0
20/04/2013,CHU de Strasbourg(Hautepierre),Urgences Adulte HTP,0,10,71,81,28,0,0
20/04/2013,Clinique des 3 Frontières,UPATOU (Structure des urgences),1,5,30,36,2,0,0
20/04/2013,Clinique des Diaconesses,SOS Main,0,0,32,32,0,0,0
20/04/2013,Clinique Ste Odile (Strasbourg,UPATOU,2,0,69,71,2,4,2
20/04/2013,CMCO,GYNECO-OBSTETRIQUE,0,0,0,0,0,0,0
20/04/2013,SIHCUS/CMCO,GYNECOLOGIE ET OBSTETRIQUE - CMCO,0,0,0,0,0,0,0
19/04/2013,CCOM,CCOM Chirurgie,0,0,33,33,4,0,0
19/04/2013,CH Altkirch,Upatou,0,5,34,39,7,1,1
19/04/2013,CH de Colmar (CMC Le Parc),SAU Le Parc,7,0,31,38,10,0,0
19/04/2013,CH de Colmar (Louis Pasteur),SAU Pasteur,0,10,133,143,25,14,8
19/04/2013,CH de Guebwiller,UHTCD,1,4,38,43,0,0,1
19/04/2013,CH de Mulhouse ( Hasenrain),PEDIATRIE NEONATOLOGIE,13,0,22,35,7,1,1
19/04/2013,CH de Mulhouse (Emile Muller-Moenschberg,URGENCES,1,25,117,143,20,10,5
19/04/2013,CH de Saverne,PEDIATRIE,5,0,15,20,0,0,0
19/04/2013,CH de Saverne,S.A.U. (ADULTES),0,12,37,49,8,2,1
19/04/2013,CH de Sélestat,Acceuil des urgences,1,14,62,77,19,4,0
19/04/2013,CH de Thann,Urgences,1,5,36,42,1,2,3
19/04/2013,CHU de Strasbourg (Hôp. Civil),Urgences Médico-Chirurgicales NHC,0,19,60,79,47,9,1
19/04/2013,CHU de Strasbourg(Hautepierre),Urgences chirurgicales pédiatriques,12,0,38,50,7,6,0
19/04/2013,CHU de Strasbourg(Hautepierre),Gynéco-Obstétrique (HTP),0,0,26,26,12,0,0
19/04/2013,CHU de Strasbourg(Hautepierre),Urgences chirurgicales pédiatriques,2,0,46,48,8,8,0
19/04/2013,CHU de Strasbourg(Hautepierre),Urgences Adulte HTP,0,20,74,94,31,0,0
19/04/2013,Clinique des 3 Frontières,UPATOU (Structure des urgences),2,4,47,53,7,0,0
19/04/2013,Clinique des Diaconesses,SOS Main,0,1,32,33,1,0,0
19/04/2013,Clinique Ste Odile (Strasbourg,UPATOU,2,6,59,67,2,8,2
19/04/2013,CMCO,GYNECO-OBSTETRIQUE,0,0,0,0,0,0,0
19/04/2013,SIHCUS/CMCO,GYNECOLOGIE ET OBSTETRIQUE - CMCO,0,0,0,0,0,0,0
18/04/2013,CCOM,CCOM Chirurgie,0,1,35,36,9,0,0
18/04/2013,CH Altkirch,Upatou,0,5,41,46,4,0,1
18/04/2013,CH de Colmar (CMC Le Parc),SAU Le Parc,10,0,47,57,9,0,0
18/04/2013,CH de Colmar (Louis Pasteur),SAU Pasteur,0,22,78,100,13,12,0
18/04/2013,CH de Guebwiller,UHTCD,1,7,47,55,1,1,2
18/04/2013,CH de Mulhouse ( Hasenrain),PEDIATRIE NEONATOLOGIE,14,0,22,36,10,1,0
18/04/2013,CH de Mulhouse (Emile Muller-Moenschberg,URGENCES,0,20,118,138,16,15,7
18/04/2013,CH de Saverne,PEDIATRIE,5,0,21,26,6,0,0
18/04/2013,CH de Saverne,S.A.U. (ADULTES),0,15,42,57,9,1,0
18/04/2013,CH de Sélestat,Acceuil des urgences,0,12,69,81,18,9,3
18/04/2013,CH de Wissembourg,Urgences ,0,7,25,32,7,0,1
18/04/2013,CHU de Strasbourg (Hôp. Civil),Urgences Médico-Chirurgicales NHC,0,25,57,82,45,3,2
18/04/2013,CHU de Strasbourg(Hautepierre),Urgences chirurgicales pédiatriques,17,0,42,59,6,6,0
18/04/2013,CHU de Strasbourg(Hautepierre),Gynéco-Obstétrique (HTP),0,0,26,26,15,0,0
18/04/2013,CHU de Strasbourg(Hautepierre),Urgences Adulte HTP,0,21,93,114,38,0,0
18/04/2013,CHU de Strasbourg(Hautepierre),Urgences chirurgicales pédiatriques,6,0,38,44,4,5,0
18/04/2013,Clinique des 3 Frontières,UPATOU (Structure des urgences),0,9,35,44,7,0,1
18/04/2013,Clinique des Diaconesses,SOS Main,0,2,26,28,0,0,1
18/04/2013,Clinique Ste Odile (Strasbourg,UPATOU,0,2,64,66,2,7,3
18/04/2013,CMCO,GYNECO-OBSTETRIQUE,0,0,0,0,0,0,0
18/04/2013,SIHCUS/CMCO,GYNECOLOGIE ET OBSTETRIQUE - CMCO,0,0,35,35,0,0,0
17/04/2013,CCOM,CCOM Chirurgie,0,0,28,28,3,0,0
17/04/2013,CH Altkirch,Upatou,0,11,36,47,5,1,0
17/04/2013,CH de Colmar (CMC Le Parc),SAU Le Parc,8,0,42,50,10,0,0
17/04/2013,CH de Colmar (Louis Pasteur),SAU Pasteur,0,22,103,125,23,10,0
17/04/2013,CH de Guebwiller,UHTCD,0,6,42,48,2,3,5
17/04/2013,CH de Mulhouse ( Hasenrain),PEDIATRIE NEONATOLOGIE,7,0,28,35,8,2,0
17/04/2013,CH de Mulhouse (Emile Muller-Moenschberg,URGENCES,3,18,118,139,19,8,4
17/04/2013,CH de Saverne,S.A.U. (ADULTES),0,8,45,53,4,4,0
17/04/2013,CH de Saverne,PEDIATRIE,3,0,18,21,1,0,0
17/04/2013,CH de Sélestat,Acceuil des urgences,1,10,71,82,18,1,2
17/04/2013,CH de Thann,Urgences,0,9,37,46,2,1,2
17/04/2013,CH de Wissembourg,Urgences ,0,6,33,39,7,0,0
17/04/2013,CHU de Strasbourg (Hôp. Civil),Urgences Médico-Chirurgicales NHC,0,17,57,74,37,3,1
17/04/2013,CHU de Strasbourg(Hautepierre),Urgences chirurgicales pédiatriques,4,0,50,54,7,6,0
17/04/2013,CHU de Strasbourg(Hautepierre),Urgences Adulte HTP,0,16,83,99,41,0,0
17/04/2013,CHU de Strasbourg(Hautepierre),Urgences chirurgicales pédiatriques,14,0,43,57,13,12,0
17/04/2013,CHU de Strasbourg(Hautepierre),Gynéco-Obstétrique (HTP),0,0,34,34,14,0,0
17/04/2013,Clinique des 3 Frontières,UPATOU (Structure des urgences),1,4,32,37,5,0,0
17/04/2013,Clinique des Diaconesses,SOS Main,0,0,29,29,2,7,1
17/04/2013,Clinique Ste Odile (Strasbourg,UPATOU,1,4,68,73,1,8,2
17/04/2013,CMCO,GYNECO-OBSTETRIQUE,0,0,0,0,0,0,0
17/04/2013,SIHCUS/CMCO,GYNECOLOGIE ET OBSTETRIQUE - CMCO,0,0,31,31,0,0,0
16/04/2013,CCOM,CCOM Chirurgie,0,1,28,29,3,0,0
16/04/2013,CH Altkirch,Upatou,0,10,27,37,3,2,2
16/04/2013,CH de Colmar (CMC Le Parc),SAU Le Parc,5,0,43,48,10,0,0
16/04/2013,CH de Colmar (Louis Pasteur),SAU Pasteur,0,26,107,133,21,10,0
16/04/2013,CH de Guebwiller,UHTCD,1,7,34,42,3,2,0
16/04/2013,CH de Mulhouse ( Hasenrain),PEDIATRIE NEONATOLOGIE,8,0,28,36,10,0,0
16/04/2013,CH de Mulhouse (Emile Muller-Moenschberg,URGENCES,0,21,96,117,10,13,2
16/04/2013,CH de Saverne,S.A.U. (ADULTES),0,5,34,39,3,4,0
16/04/2013,CH de Saverne,PEDIATRIE,6,0,20,26,3,1,0
16/04/2013,CH de Sélestat,Acceuil des urgences,3,13,75,91,15,5,2
16/04/2013,CH de Thann,Urgences,0,8,42,50,6,1,0
16/04/2013,CH de Wissembourg,Urgences ,2,9,31,42,8,0,0
16/04/2013,CHU de Strasbourg (Hôp. Civil),Urgences Médico-Chirurgicales NHC,0,18,64,82,42,3,0
16/04/2013,CHU de Strasbourg(Hautepierre),Urgences chirurgicales pédiatriques,2,0,37,39,5,5,0
16/04/2013,CHU de Strasbourg(Hautepierre),Urgences Adulte HTP,0,22,87,109,47,0,0
16/04/2013,CHU de Strasbourg(Hautepierre),Urgences chirurgicales pédiatriques,5,0,40,45,4,4,0
16/04/2013,CHU de Strasbourg(Hautepierre),Gynéco-Obstétrique (HTP),1,0,31,32,16,0,0
16/04/2013,Clinique des 3 Frontières,UPATOU (Structure des urgences),0,1,45,46,3,0,0
16/04/2013,Clinique Ste Odile (Strasbourg,UPATOU,1,6,60,67,2,8,2
16/04/2013,CMCO,GYNECO-OBSTETRIQUE,0,0,0,0,0,0,0
16/04/2013,SIHCUS/CMCO,GYNECOLOGIE ET OBSTETRIQUE - CMCO,0,0,0,0,0,0,0
15/04/2013,CCOM,CCOM Chirurgie,0,1,29,30,6,0,0
15/04/2013,CH Altkirch,Upatou,0,7,45,52,6,2,4
15/04/2013,CH de Colmar (CMC Le Parc),SAU Le Parc,4,0,41,45,8,0,0
15/04/2013,CH de Colmar (Louis Pasteur),SAU Pasteur,0,21,124,145,24,13,3
15/04/2013,CH de Guebwiller,UHTCD,0,4,35,39,3,1,0
15/04/2013,CH de Mulhouse ( Hasenrain),PEDIATRIE NEONATOLOGIE,18,0,27,45,3,1,0
15/04/2013,CH de Mulhouse (Emile Muller-Moenschberg,URGENCES,0,22,101,123,16,12,1
15/04/2013,CH de Saverne,S.A.U. (ADULTES),0,8,56,64,8,1,0
15/04/2013,CH de Saverne,PEDIATRIE,6,0,21,27,3,1,0
15/04/2013,CH de Sélestat,Acceuil des urgences,3,13,83,99,11,4,1
15/04/2013,CH de Thann,Urgences,0,2,43,45,2,1,1
15/04/2013,CH de Wissembourg,Urgences ,1,7,35,43,10,0,0
15/04/2013,CHU de Strasbourg (Hôp. Civil),Urgences Médico-Chirurgicales NHC,0,21,66,87,48,6,0
15/04/2013,CHU de Strasbourg(Hautepierre),Urgences chirurgicales pédiatriques,13,0,34,47,6,6,0
15/04/2013,CHU de Strasbourg(Hautepierre),Gynéco-Obstétrique (HTP),0,0,25,25,11,0,0
15/04/2013,CHU de Strasbourg(Hautepierre),Urgences Adulte HTP,0,17,86,103,32,0,2
15/04/2013,CHU de Strasbourg(Hautepierre),Urgences chirurgicales pédiatriques,5,0,51,56,10,10,0
15/04/2013,Clinique des 3 Frontières,UPATOU (Structure des urgences),2,11,40,53,8,0,4
15/04/2013,Clinique des Diaconesses,SOS Main,0,1,44,45,0,0,0
15/04/2013,Clinique Ste Odile (Strasbourg,UPATOU,0,5,65,70,3,5,1
15/04/2013,CMCO,GYNECO-OBSTETRIQUE,0,0,0,0,0,0,0
15/04/2013,SIHCUS/CMCO,GYNECOLOGIE ET OBSTETRIQUE - CMCO,0,0,0,0,0,0,0
14/04/2013,CCOM,CCOM Chirurgie,0,0,20,20,4,0,0
14/04/2013,CH Altkirch,Upatou,0,8,39,47,4,2,1
14/04/2013,CH de Colmar (CMC Le Parc),SAU Le Parc,11,0,50,61,11,0,0
14/04/2013,CH de Colmar (Louis Pasteur),SAU Pasteur,0,23,120,143,13,10,1
14/04/2013,CH de Guebwiller,UHTCD,0,4,44,48,1,4,3
14/04/2013,CH de Mulhouse ( Hasenrain),PEDIATRIE NEONATOLOGIE,8,0,30,38,6,2,0
14/04/2013,CH de Mulhouse (Emile Muller-Moenschberg,URGENCES,0,17,122,139,14,8,0
14/04/2013,CH de Saverne,S.A.U. (ADULTES),0,6,53,59,7,3,0
14/04/2013,CH de Saverne,PEDIATRIE,6,0,25,31,5,0,0
14/04/2013,CH de Sélestat,Acceuil des urgences,2,8,75,85,14,7,3
14/04/2013,CH de Thann,Urgences,0,5,43,48,3,2,4
14/04/2013,CH de Wissembourg,Urgences ,0,5,35,40,8,0,0
14/04/2013,CHU de Strasbourg (Hôp. Civil),Urgences Médico-Chirurgicales NHC,0,15,65,80,32,3,0
14/04/2013,CHU de Strasbourg(Hautepierre),Urgences chirurgicales pédiatriques,3,0,56,59,7,7,0
14/04/2013,CHU de Strasbourg(Hautepierre),Urgences chirurgicales pédiatriques,26,0,48,74,8,8,0
14/04/2013,CHU de Strasbourg(Hautepierre),Gynéco-Obstétrique (HTP),0,0,24,24,11,0,0
14/04/2013,CHU de Strasbourg(Hautepierre),Urgences Adulte HTP,0,17,99,116,41,0,0
14/04/2013,Clinique des 3 Frontières,UPATOU (Structure des urgences),1,4,44,49,8,0,0
14/04/2013,Clinique des Diaconesses,SOS Main,0,2,25,27,0,0,0
14/04/2013,Clinique Ste Odile (Strasbourg,UPATOU,1,3,70,74,0,3,1
14/04/2013,CMCO,GYNECO-OBSTETRIQUE,0,0,0,0,0,0,0
14/04/2013,SIHCUS/CMCO,GYNECOLOGIE ET OBSTETRIQUE - CMCO,0,0,0,0,0,0,0
13/04/2013,CCOM,CCOM Chirurgie,0,0,21,21,1,0,0
13/04/2013,CH Altkirch,Upatou,1,3,37,41,1,0,0
13/04/2013,CH de Colmar (CMC Le Parc),SAU Le Parc,11,0,45,56,7,0,0
13/04/2013,CH de Colmar (Louis Pasteur),SAU Pasteur,0,22,113,135,20,10,2
13/04/2013,CH de Guebwiller,UHTCD,0,8,39,47,2,1,2
13/04/2013,CH de Mulhouse ( Hasenrain),PEDIATRIE NEONATOLOGIE,9,0,35,44,3,2,0
13/04/2013,CH de Mulhouse (Emile Muller-Moenschberg,URGENCES,1,19,142,162,14,15,1
13/04/2013,CH de Saverne,S.A.U. (ADULTES),0,8,42,50,5,3,0
13/04/2013,CH de Saverne,PEDIATRIE,5,0,20,25,4,0,0
13/04/2013,CH de Sélestat,Acceuil des urgences,3,12,79,94,16,3,3
13/04/2013,CH de Thann,Urgences,0,3,37,40,3,0,3
13/04/2013,CH de Wissembourg,Urgences ,0,2,24,26,4,0,0
13/04/2013,CHU de Strasbourg (Hôp. Civil),Urgences Médico-Chirurgicales NHC,0,15,91,106,37,3,0
13/04/2013,CHU de Strasbourg(Hautepierre),Urgences chirurgicales pédiatriques,20,0,38,58,6,6,0
13/04/2013,CHU de Strasbourg(Hautepierre),Gynéco-Obstétrique (HTP),0,0,31,31,12,0,0
13/04/2013,CHU de Strasbourg(Hautepierre),Urgences Adulte HTP,0,22,78,100,40,0,1
13/04/2013,CHU de Strasbourg(Hautepierre),Urgences chirurgicales pédiatriques,1,0,75,76,11,10,0
13/04/2013,Clinique des 3 Frontières,UPATOU (Structure des urgences),3,8,32,43,9,0,0
13/04/2013,Clinique des Diaconesses,SOS Main,0,2,37,39,0,0,2
13/04/2013,Clinique Ste Odile (Strasbourg,UPATOU,0,3,81,84,0,6,5
13/04/2013,CMCO,GYNECO-OBSTETRIQUE,0,0,0,0,0,0,0
13/04/2013,SIHCUS/CMCO,GYNECOLOGIE ET OBSTETRIQUE - CMCO,0,0,0,0,0,0,0
12/04/2013,CCOM,CCOM Chirurgie,0,1,21,22,2,0,0
12/04/2013,CH Altkirch,Upatou,0,7,30,37,8,0,1
12/04/2013,CH de Colmar (CMC Le Parc),SAU Le Parc,5,0,28,33,0,2,0
12/04/2013,CH de Colmar (Louis Pasteur),SAU Pasteur,0,28,105,133,32,11,2
12/04/2013,CH de Guebwiller,UHTCD,0,6,26,32,0,2,0
12/04/2013,CH de Mulhouse ( Hasenrain),PEDIATRIE NEONATOLOGIE,8,0,22,30,9,0,0
12/04/2013,CH de Mulhouse (Emile Muller-Moenschberg,URGENCES,0,28,92,120,21,13,2
12/04/2013,CH de Saverne,S.A.U. (ADULTES),0,12,40,52,14,2,0
12/04/2013,CH de Saverne,PEDIATRIE,5,0,14,19,2,1,0
12/04/2013,CH de Sélestat,Acceuil des urgences,1,18,61,80,19,3,4
12/04/2013,CH de Thann,Urgences,0,4,42,46,2,2,1
12/04/2013,CH de Wissembourg,Urgences ,0,3,32,35,6,0,0
12/04/2013,CHU de Strasbourg (Hôp. Civil),Urgences Médico-Chirurgicales NHC,1,16,62,79,44,3,2
12/04/2013,CHU de Strasbourg(Hautepierre),Urgences Adulte HTP,1,17,91,109,43,0,0
12/04/2013,CHU de Strasbourg(Hautepierre),Urgences chirurgicales pédiatriques,15,0,38,53,8,8,0
12/04/2013,CHU de Strasbourg(Hautepierre),Gynéco-Obstétrique (HTP),0,0,26,26,13,0,0
12/04/2013,CHU de Strasbourg(Hautepierre),Urgences chirurgicales pédiatriques,1,0,46,47,8,7,0
12/04/2013,Clinique des 3 Frontières,UPATOU (Structure des urgences),0,2,38,40,2,0,0
12/04/2013,Clinique des Diaconesses,SOS Main,0,0,34,34,0,0,0
12/04/2013,Clinique Ste Odile (Strasbourg,UPATOU,0,5,67,72,6,10,3
12/04/2013,CMCO,GYNECO-OBSTETRIQUE,0,0,0,0,0,0,0
12/04/2013,SIHCUS/CMCO,GYNECOLOGIE ET OBSTETRIQUE - CMCO,0,0,0,0,0,0,0
11/04/2013,CCOM,CCOM Chirurgie,0,0,22,22,1,0,0
11/04/2013,CH Altkirch,Upatou,1,4,29,34,4,2,1
11/04/2013,CH de Colmar (CMC Le Parc),SAU Le Parc,12,0,56,68,18,0,0
11/04/2013,CH de Colmar (Louis Pasteur),SAU Pasteur,0,24,101,125,15,13,0
11/04/2013,CH de Guebwiller,UHTCD,0,5,45,50,3,2,3
11/04/2013,CH de Mulhouse ( Hasenrain),PEDIATRIE NEONATOLOGIE,12,0,25,37,6,4,1
11/04/2013,CH de Mulhouse (Emile Muller-Moenschberg,URGENCES,1,17,105,123,10,8,1
11/04/2013,CH de Saverne,S.A.U. (ADULTES),0,9,41,50,9,6,0
11/04/2013,CH de Saverne,PEDIATRIE,2,0,25,27,5,0,0
11/04/2013,CH de Sélestat,Acceuil des urgences,7,12,65,84,12,4,1
11/04/2013,CH de Thann,Urgences,0,4,33,37,2,1,1
11/04/2013,CH de Wissembourg,Urgences ,0,0,23,23,2,0,1
11/04/2013,CHU de Strasbourg (Hôp. Civil),Urgences Médico-Chirurgicales NHC,0,23,66,89,51,1,1
11/04/2013,CHU de Strasbourg(Hautepierre),Urgences Adulte HTP,0,14,83,97,33,0,1
11/04/2013,CHU de Strasbourg(Hautepierre),Urgences chirurgicales pédiatriques,19,0,35,54,11,12,0
11/04/2013,CHU de Strasbourg(Hautepierre),Gynéco-Obstétrique (HTP),0,0,26,26,13,0,0
11/04/2013,CHU de Strasbourg(Hautepierre),Urgences chirurgicales pédiatriques,0,0,43,43,4,4,0
11/04/2013,Clinique des 3 Frontières,UPATOU (Structure des urgences),1,5,38,44,8,0,1
11/04/2013,Clinique des Diaconesses,SOS Main,0,1,30,31,0,0,0
11/04/2013,Clinique Ste Odile (Strasbourg,UPATOU,1,1,77,79,1,8,2
11/04/2013,CMCO,GYNECO-OBSTETRIQUE,0,0,0,0,0,0,0
11/04/2013,SIHCUS/CMCO,GYNECOLOGIE ET OBSTETRIQUE - CMCO,0,0,0,0,0,0,0
10/04/2013,CCOM,CCOM Chirurgie,0,0,16,16,1,0,0
10/04/2013,CH Altkirch,Upatou,0,89,34,123,5,3,1
10/04/2013,CH de Colmar (CMC Le Parc),SAU Le Parc,9,0,42,51,11,0,0
10/04/2013,CH de Colmar (Louis Pasteur),SAU Pasteur,0,20,107,127,19,15,0
10/04/2013,CH de Guebwiller,UHTCD,0,5,26,31,3,3,0
10/04/2013,CH de Mulhouse ( Hasenrain),PEDIATRIE NEONATOLOGIE,7,0,18,25,4,1,0
10/04/2013,CH de Mulhouse (Emile Muller-Moenschberg,URGENCES,1,27,104,132,10,8,4
10/04/2013,CH de Saverne,S.A.U. (ADULTES),0,10,34,44,7,5,2
10/04/2013,CH de Saverne,PEDIATRIE,3,0,24,27,2,2,0
10/04/2013,CH de Sélestat,Acceuil des urgences,1,9,68,78,17,5,0
10/04/2013,CH de Thann,Urgences,0,5,24,29,2,0,1
10/04/2013,CH de Wissembourg,Urgences ,1,5,25,31,6,4,1
10/04/2013,CHU de Strasbourg (Hôp. Civil),Urgences Médico-Chirurgicales NHC,0,15,61,76,52,1,2
10/04/2013,CHU de Strasbourg(Hautepierre),Urgences chirurgicales pédiatriques,22,0,33,55,11,10,0
10/04/2013,CHU de Strasbourg(Hautepierre),Urgences chirurgicales pédiatriques,2,0,57,59,8,6,0
10/04/2013,CHU de Strasbourg(Hautepierre),Urgences Adulte HTP,0,22,63,85,34,0,0
10/04/2013,CHU de Strasbourg(Hautepierre),Urgences chirurgicales pédiatriques,2,0,57,59,8,6,0
10/04/2013,CHU de Strasbourg(Hautepierre),Gynéco-Obstétrique (HTP),0,0,32,32,8,0,0
10/04/2013,Clinique des 3 Frontières,UPATOU (Structure des urgences),1,4,47,52,8,0,0
10/04/2013,Clinique Ste Odile (Strasbourg,UPATOU,0,3,75,78,1,8,3
10/04/2013,CMCO,GYNECO-OBSTETRIQUE,0,0,0,0,0,0,0
10/04/2013,SIHCUS/CMCO,GYNECOLOGIE ET OBSTETRIQUE - CMCO,0,0,0,0,0,0,0
9/04/2013,CCOM,CCOM Chirurgie,0,0,20,20,1,0,0
9/04/2013,CH Altkirch,Upatou,0,5,24,29,3,1,1
9/04/2013,CH de Colmar (CMC Le Parc),SAU Le Parc,6,0,50,56,12,0,0
9/04/2013,CH de Colmar (Louis Pasteur),SAU Pasteur,0,29,105,134,17,14,0
9/04/2013,CH de Guebwiller,UHTCD,0,7,40,47,1,3,1
9/04/2013,CH de Mulhouse ( Hasenrain),PEDIATRIE NEONATOLOGIE,20,0,29,49,8,1,1
9/04/2013,CH de Mulhouse (Emile Muller-Moenschberg,URGENCES,2,17,102,121,10,11,3
9/04/2013,CH de Saverne,PEDIATRIE,7,0,22,29,3,0,0
9/04/2013,CH de Saverne,S.A.U. (ADULTES),0,11,48,59,8,4,1
9/04/2013,CH de Sélestat,Acceuil des urgences,0,15,59,74,9,5,2
9/04/2013,CH de Thann,Urgences,0,1,42,43,1,1,0
9/04/2013,CH de Wissembourg,Urgences ,0,9,25,34,12,1,0
9/04/2013,CHU de Strasbourg (Hôp. Civil),Urgences Médico-Chirurgicales NHC,0,18,55,73,42,6,0
9/04/2013,CHU de Strasbourg(Hautepierre),Urgences chirurgicales pédiatriques,2,0,35,37,1,1,0
9/04/2013,CHU de Strasbourg(Hautepierre),Urgences chirurgicales pédiatriques,12,0,47,59,11,11,0
9/04/2013,CHU de Strasbourg(Hautepierre),Gynéco-Obstétrique (HTP),1,0,24,25,7,0,0
9/04/2013,CHU de Strasbourg(Hautepierre),Urgences Adulte HTP,0,11,87,98,30,0,0
9/04/2013,Clinique des 3 Frontières,UPATOU (Structure des urgences),1,7,32,40,10,0,0
9/04/2013,Clinique Ste Odile (Strasbourg,UPATOU,0,2,47,49,1,4,0
9/04/2013,CMCO,GYNECO-OBSTETRIQUE,0,0,0,0,0,0,0
9/04/2013,SIHCUS/CMCO,GYNECOLOGIE ET OBSTETRIQUE - CMCO,0,0,0,0,0,0,0
8/04/2013,CCOM,CCOM Chirurgie,0,1,30,31,1,0,0
8/04/2013,CH Altkirch,Upatou,0,4,38,42,0,1,0
8/04/2013,CH de Colmar (CMC Le Parc),SAU Le Parc,7,0,41,48,9,0,0
8/04/2013,CH de Colmar (Louis Pasteur),SAU Pasteur,0,32,105,137,24,13,0
8/04/2013,CH de Guebwiller,UHTCD,1,7,43,51,3,1,0
8/04/2013,CH de Mulhouse ( Hasenrain),PEDIATRIE NEONATOLOGIE,7,0,26,33,5,1,1
8/04/2013,CH de Mulhouse (Emile Muller-Moenschberg,URGENCES,0,23,116,139,14,9,5
8/04/2013,CH de Saverne,PEDIATRIE,5,0,16,21,3,1,0
8/04/2013,CH de Saverne,S.A.U. (ADULTES),0,13,58,71,17,7,0
8/04/2013,CH de Sélestat,Acceuil des urgences,2,19,76,97,16,5,1
8/04/2013,CH de Thann,Urgences,0,4,48,52,4,0,0
8/04/2013,CH de Wissembourg,Urgences ,0,5,34,39,8,1,0
8/04/2013,CHU de Strasbourg (Hôp. Civil),Urgences Médico-Chirurgicales NHC,0,21,73,94,50,5,1
8/04/2013,CHU de Strasbourg(Hautepierre),Urgences chirurgicales pédiatriques,11,0,50,61,5,5,0
8/04/2013,CHU de Strasbourg(Hautepierre),Gynéco-Obstétrique (HTP),0,0,32,32,15,0,0
8/04/2013,CHU de Strasbourg(Hautepierre),Urgences Adulte HTP,0,16,84,100,34,0,0
8/04/2013,CHU de Strasbourg(Hautepierre),Urgences chirurgicales pédiatriques,2,0,58,60,3,3,0
8/04/2013,Clinique des 3 Frontières,UPATOU (Structure des urgences),2,6,30,38,6,0,0
8/04/2013,Clinique des Diaconesses,SOS Main,0,3,42,45,0,0,1
8/04/2013,Clinique Ste Odile (Strasbourg,UPATOU,0,2,77,79,0,6,1
8/04/2013,CMCO,GYNECO-OBSTETRIQUE,0,0,0,0,0,0,0
8/04/2013,SIHCUS/CMCO,GYNECOLOGIE ET OBSTETRIQUE - CMCO,0,0,0,0,0,0,0
7/04/2013,CCOM,CCOM Chirurgie,0,0,24,24,1,0,0
7/04/2013,CH Altkirch,Upatou,0,7,39,46,4,4,2
7/04/2013,CH de Colmar (CMC Le Parc),SAU Le Parc,15,0,49,64,13,0,0
7/04/2013,CH de Colmar (Louis Pasteur),SAU Pasteur,0,15,117,132,17,11,0
7/04/2013,CH de Guebwiller,UHTCD,0,8,35,43,3,1,1
7/04/2013,CH de Mulhouse ( Hasenrain),PEDIATRIE NEONATOLOGIE,16,0,23,39,8,1,0
7/04/2013,CH de Mulhouse (Emile Muller-Moenschberg,URGENCES,0,15,111,126,16,14,2
7/04/2013,CH de Saverne,PEDIATRIE,4,0,21,25,4,1,0
7/04/2013,CH de Saverne,S.A.U. (ADULTES),0,4,47,51,7,0,0
7/04/2013,CH de Sélestat,Acceuil des urgences,1,9,95,105,10,4,0
7/04/2013,CH de Thann,Urgences,0,7,45,52,3,2,2
7/04/2013,CH de Wissembourg,Urgences ,4,3,33,40,4,0,0
7/04/2013,CHU de Strasbourg (Hôp. Civil),Urgences Médico-Chirurgicales NHC,0,12,72,84,37,1,0
7/04/2013,CHU de Strasbourg(Hautepierre),Urgences chirurgicales pédiatriques,1,0,58,59,5,4,0
7/04/2013,CHU de Strasbourg(Hautepierre),Urgences Adulte HTP,0,20,77,97,33,0,1
7/04/2013,CHU de Strasbourg(Hautepierre),Urgences chirurgicales pédiatriques,15,0,49,64,11,10,0
7/04/2013,CHU de Strasbourg(Hautepierre),Gynéco-Obstétrique (HTP),0,0,29,29,8,0,0
7/04/2013,Clinique des 3 Frontières,UPATOU (Structure des urgences),0,2,51,53,1,0,1
7/04/2013,Clinique des Diaconesses,SOS Main,0,0,23,23,0,0,0
7/04/2013,Clinique Ste Odile (Strasbourg,UPATOU,2,3,80,85,0,8,1
7/04/2013,CMCO,GYNECO-OBSTETRIQUE,0,0,0,0,0,0,0
7/04/2013,SIHCUS/CMCO,GYNECOLOGIE ET OBSTETRIQUE - CMCO,0,0,0,0,0,0,0
6/04/2013,CCOM,CCOM Chirurgie,0,2,30,32,5,0,0
6/04/2013,CH Altkirch,Upatou,0,12,34,46,6,0,3
6/04/2013,CH de Colmar (CMC Le Parc),SAU Le Parc,11,0,25,36,6,0,0
6/04/2013,CH de Colmar (Louis Pasteur),SAU Pasteur,0,18,98,116,24,6,2
6/04/2013,CH de Guebwiller,UHTCD,0,3,39,42,2,1,2
6/04/2013,CH de Mulhouse ( Hasenrain),PEDIATRIE NEONATOLOGIE,16,0,25,41,6,3,0
6/04/2013,CH de Mulhouse (Emile Muller-Moenschberg,URGENCES,0,29,131,160,17,12,2
6/04/2013,CH de Saverne,PEDIATRIE,3,0,22,25,3,0,0
6/04/2013,CH de Saverne,S.A.U. (ADULTES),0,6,49,55,9,5,2
6/04/2013,CH de Sélestat,Acceuil des urgences,2,11,79,92,14,1,0
6/04/2013,CH de Thann,Urgences,0,5,42,47,1,0,2
6/04/2013,CH de Wissembourg,Urgences ,1,6,29,36,9,0,0
6/04/2013,CHU de Strasbourg (Hôp. Civil),Urgences Médico-Chirurgicales NHC,0,24,79,103,46,1,3
6/04/2013,CHU de Strasbourg(Hautepierre),Urgences chirurgicales pédiatriques,18,0,46,64,7,7,0
6/04/2013,CHU de Strasbourg(Hautepierre),Gynéco-Obstétrique (HTP),1,0,29,30,17,0,0
6/04/2013,CHU de Strasbourg(Hautepierre),Urgences chirurgicales pédiatriques,1,0,59,60,7,7,0
6/04/2013,CHU de Strasbourg(Hautepierre),Urgences Adulte HTP,0,13,87,100,36,0,0
6/04/2013,Clinique des 3 Frontières,UPATOU (Structure des urgences),0,0,42,42,5,0,0
6/04/2013,Clinique des Diaconesses,SOS Main,0,1,33,34,0,0,1
6/04/2013,Clinique Ste Odile (Strasbourg,UPATOU,0,6,67,73,1,6,1
6/04/2013,CMCO,GYNECO-OBSTETRIQUE,0,0,0,0,0,0,0
6/04/2013,SIHCUS/CMCO,GYNECOLOGIE ET OBSTETRIQUE - CMCO,0,0,0,0,0,0,0
5/04/2013,CCOM,CCOM Chirurgie,0,1,26,27,3,0,0
5/04/2013,CH Altkirch,Upatou,0,8,22,30,9,1,2
5/04/2013,CH de Colmar (CMC Le Parc),SAU Le Parc,15,0,45,60,7,0,0
5/04/2013,CH de Colmar (Louis Pasteur),SAU Pasteur,0,21,101,122,29,8,2
5/04/2013,CH de Guebwiller,UHTCD,0,7,39,46,5,0,1
5/04/2013,CH de Mulhouse ( Hasenrain),PEDIATRIE NEONATOLOGIE,14,0,25,39,4,2,0
5/04/2013,CH de Mulhouse (Emile Muller-Moenschberg,URGENCES,1,31,126,158,26,9,1
5/04/2013,CH de Saverne,PEDIATRIE,3,0,20,23,2,0,0
5/04/2013,CH de Saverne,S.A.U. (ADULTES),0,9,43,52,10,2,0
5/04/2013,CH de Sélestat,Acceuil des urgences,2,15,73,90,19,4,2
5/04/2013,CH de Thann,Urgences,0,3,35,38,1,2,1
5/04/2013,CH de Wissembourg,Urgences ,0,8,34,42,8,0,0
5/04/2013,CHU de Strasbourg (Hôp. Civil),Urgences Médico-Chirurgicales NHC,0,22,59,81,43,2,0
5/04/2013,CHU de Strasbourg(Hautepierre),Urgences chirurgicales pédiatriques,12,0,47,59,7,5,0
5/04/2013,CHU de Strasbourg(Hautepierre),Gynéco-Obstétrique (HTP),0,0,29,29,19,0,0
5/04/2013,CHU de Strasbourg(Hautepierre),Urgences Adulte HTP,0,19,92,111,46,0,1
5/04/2013,CHU de Strasbourg(Hautepierre),Urgences chirurgicales pédiatriques,5,0,44,49,7,7,0
5/04/2013,Clinique des 3 Frontières,UPATOU (Structure des urgences),1,3,35,39,5,0,0
5/04/2013,Clinique des Diaconesses,SOS Main,0,0,29,29,7,0,0
5/04/2013,Clinique Ste Odile (Strasbourg,UPATOU,1,6,61,68,4,6,1
5/04/2013,CMCO,GYNECO-OBSTETRIQUE,0,0,0,0,0,0,0
5/04/2013,SIHCUS/CMCO,GYNECOLOGIE ET OBSTETRIQUE - CMCO,0,0,0,0,0,0,0
4/04/2013,CCOM,CCOM Chirurgie,0,2,20,22,4,0,0
4/04/2013,CH Altkirch,Upatou,0,6,36,42,3,0,2
4/04/2013,CH de Colmar (CMC Le Parc),SAU Le Parc,9,0,52,61,9,0,0
4/04/2013,CH de Colmar (Louis Pasteur),SAU Pasteur,0,30,94,124,29,11,0
4/04/2013,CH de Guebwiller,UHTCD,0,4,33,37,3,1,1
4/04/2013,CH de Mulhouse ( Hasenrain),PEDIATRIE NEONATOLOGIE,13,0,28,41,2,3,0
4/04/2013,CH de Mulhouse (Emile Muller-Moenschberg,URGENCES,0,24,93,117,17,8,3
4/04/2013,CH de Saverne,PEDIATRIE,4,0,28,32,2,0,0
4/04/2013,CH de Saverne,S.A.U. (ADULTES),0,6,50,56,9,5,1
4/04/2013,CH de Thann,Urgences,0,4,46,50,1,1,2
4/04/2013,CH de Wissembourg,Urgences ,0,9,22,31,5,2,3
4/04/2013,CHU de Strasbourg (Hôp. Civil),Urgences Médico-Chirurgicales NHC,0,26,62,88,42,3,0
4/04/2013,CHU de Strasbourg(Hautepierre),Urgences chirurgicales pédiatriques,18,0,46,64,7,7,0
4/04/2013,CHU de Strasbourg(Hautepierre),Gynéco-Obstétrique (HTP),1,0,27,28,8,0,0
4/04/2013,CHU de Strasbourg(Hautepierre),Urgences chirurgicales pédiatriques,1,0,46,47,0,0,0
4/04/2013,CHU de Strasbourg(Hautepierre),Urgences Adulte HTP,0,25,72,97,37,0,0
4/04/2013,Clinique des 3 Frontières,UPATOU (Structure des urgences),1,4,44,49,3,0,1
4/04/2013,Clinique Ste Odile (Strasbourg,UPATOU,0,6,55,61,1,6,3
4/04/2013,CMCO,GYNECO-OBSTETRIQUE,0,0,0,0,0,0,0
4/04/2013,SIHCUS/CMCO,GYNECOLOGIE ET OBSTETRIQUE - CMCO,0,0,0,0,0,0,0
3/04/2013,CCOM,CCOM Chirurgie,0,3,34,37,4,0,0
3/04/2013,CH Altkirch,Upatou,0,6,42,48,4,3,1
3/04/2013,CH de Colmar (CMC Le Parc),SAU Le Parc,6,0,36,42,10,0,0
3/04/2013,CH de Colmar (Louis Pasteur),SAU Pasteur,0,21,115,136,18,10,2
3/04/2013,CH de Guebwiller,UHTCD,0,3,36,39,3,3,1
3/04/2013,CH de Mulhouse ( Hasenrain),PEDIATRIE NEONATOLOGIE,12,0,29,41,12,2,0
3/04/2013,CH de Mulhouse (Emile Muller-Moenschberg,URGENCES,3,11,117,131,10,16,3
3/04/2013,CH de Saverne,PEDIATRIE,4,0,19,23,1,0,0
3/04/2013,CH de Saverne,S.A.U. (ADULTES),0,19,45,64,14,4,3
3/04/2013,CH de Sélestat,Acceuil des urgences,0,7,47,54,10,2,1
3/04/2013,CH de Thann,Urgences,1,8,35,44,8,1,2
3/04/2013,CH de Wissembourg,Urgences ,0,0,22,22,3,0,1
3/04/2013,CHU de Strasbourg (Hôp. Civil),Urgences Médico-Chirurgicales NHC,0,11,55,66,43,2,2
3/04/2013,CHU de Strasbourg(Hautepierre),Gynéco-Obstétrique (HTP),0,0,21,21,5,0,0
3/04/2013,CHU de Strasbourg(Hautepierre),Urgences Adulte HTP,0,22,76,98,35,0,0
3/04/2013,CHU de Strasbourg(Hautepierre),Urgences chirurgicales pédiatriques,3,0,58,61,1,1,0
3/04/2013,CHU de Strasbourg(Hautepierre),Urgences chirurgicales pédiatriques,16,0,38,54,8,8,0
3/04/2013,Clinique des 3 Frontières,UPATOU (Structure des urgences),0,5,26,31,5,0,0
3/04/2013,Clinique des Diaconesses,SOS Main,0,1,26,27,8,0,0
3/04/2013,Clinique Ste Odile (Strasbourg,UPATOU,0,5,60,65,3,10,2
3/04/2013,CMCO,GYNECO-OBSTETRIQUE,0,0,0,0,0,0,0
3/04/2013,SIHCUS/CMCO,GYNECOLOGIE ET OBSTETRIQUE - CMCO,0,0,0,0,0,0,0
2/04/2013,CCOM,CCOM Chirurgie,0,1,33,34,3,0,0
2/04/2013,CH Altkirch,Upatou,0,5,37,42,8,2,0
2/04/2013,CH de Colmar (CMC Le Parc),SAU Le Parc,7,0,43,50,10,1,0
2/04/2013,CH de Colmar (Louis Pasteur),SAU Pasteur,0,30,122,152,23,9,0
2/04/2013,CH de Guebwiller,UHTCD,0,6,53,59,1,3,0
2/04/2013,CH de Mulhouse ( Hasenrain),PEDIATRIE NEONATOLOGIE,9,0,24,33,7,1,0
2/04/2013,CH de Mulhouse (Emile Muller-Moenschberg,URGENCES,2,28,100,130,10,17,2
2/04/2013,CH de Saverne,PEDIATRIE,7,0,18,25,4,0,0
2/04/2013,CH de Saverne,S.A.U. (ADULTES),0,8,53,61,13,5,1
2/04/2013,CH de Sélestat,Acceuil des urgences,3,16,84,103,21,4,2
2/04/2013,CH de Thann,Urgences,1,7,40,48,5,0,0
2/04/2013,CH de Wissembourg,Urgences ,0,10,28,38,8,0,1
2/04/2013,CHU de Strasbourg (Hôp. Civil),Urgences Médico-Chirurgicales NHC,0,32,51,83,56,1,1
2/04/2013,CHU de Strasbourg(Hautepierre),Gynéco-Obstétrique (HTP),0,0,32,32,18,0,0
2/04/2013,CHU de Strasbourg(Hautepierre),Urgences Adulte HTP,0,20,91,111,45,0,0
2/04/2013,CHU de Strasbourg(Hautepierre),Urgences chirurgicales pédiatriques,2,0,69,71,4,5,0
2/04/2013,CHU de Strasbourg(Hautepierre),Urgences chirurgicales pédiatriques,11,0,58,69,14,14,0
2/04/2013,Clinique des 3 Frontières,UPATOU (Structure des urgences),0,5,46,51,4,0,0
2/04/2013,Clinique des Diaconesses,SOS Main,0,1,36,37,0,0,0
2/04/2013,Clinique Ste Odile (Strasbourg,UPATOU,0,7,68,75,1,6,1
2/04/2013,CMCO,GYNECO-OBSTETRIQUE,0,0,0,0,0,0,0
2/04/2013,SIHCUS/CMCO,GYNECOLOGIE ET OBSTETRIQUE - CMCO,0,0,0,0,0,0,0
1/04/2013,CCOM,CCOM Chirurgie,0,1,21,22,2,0,0
1/04/2013,CH Altkirch,Upatou,0,4,34,38,2,3,0
1/04/2013,CH de Colmar (CMC Le Parc),SAU Le Parc,15,0,48,63,8,0,0
1/04/2013,CH de Colmar (Louis Pasteur),SAU Pasteur,0,19,112,131,18,8,0
1/04/2013,CH de Guebwiller,UHTCD,0,3,33,36,1,2,1
1/04/2013,CH de Mulhouse ( Hasenrain),PEDIATRIE NEONATOLOGIE,23,0,34,57,5,3,0
1/04/2013,CH de Mulhouse (Emile Muller-Moenschberg,URGENCES,1,16,134,151,25,7,6
1/04/2013,CH de Saverne,S.A.U. (ADULTES),0,13,54,67,7,3,0
1/04/2013,CH de Saverne,PEDIATRIE,4,0,32,36,3,1,0
1/04/2013,CH de Sélestat,Acceuil des urgences,3,5,93,101,9,4,2
1/04/2013,CH de Thann,Urgences,0,7,37,44,1,1,0
1/04/2013,CH de Wissembourg,Urgences ,1,6,41,48,5,0,1
1/04/2013,CHU de Strasbourg (Hôp. Civil),Urgences Médico-Chirurgicales NHC,0,22,58,80,37,0,0
1/04/2013,CHU de Strasbourg(Hautepierre),Urgences chirurgicales pédiatriques,8,0,65,73,8,7,0
1/04/2013,CHU de Strasbourg(Hautepierre),Urgences Adulte HTP,0,18,61,79,26,0,0
1/04/2013,CHU de Strasbourg(Hautepierre),Urgences chirurgicales pédiatriques,17,0,68,85,8,8,0
1/04/2013,CHU de Strasbourg(Hautepierre),Gynéco-Obstétrique (HTP),0,0,27,27,13,0,0
1/04/2013,Clinique des 3 Frontières,UPATOU (Structure des urgences),0,4,41,45,6,0,2
1/04/2013,Clinique des Diaconesses,SOS Main,0,0,25,25,1,0,0
1/04/2013,Clinique Ste Odile (Strasbourg,UPATOU,2,2,81,85,4,6,3
1/04/2013,CMCO,GYNECO-OBSTETRIQUE,0,0,0,0,0,0,0
1/04/2013,SIHCUS/CMCO,GYNECOLOGIE ET OBSTETRIQUE - CMCO,0,0,0,0,0,0,0
31/03/2013,CCOM,CCOM Chirurgie,0,0,9,9,3,0,0
31/03/2013,CH de Colmar (CMC Le Parc),SAU Le Parc,13,0,45,58,15,0,0
31/03/2013,CH de Colmar (Louis Pasteur),SAU Pasteur,0,19,81,100,13,22,1
31/03/2013,CH de Guebwiller,UHTCD,1,4,29,34,1,0,0
31/03/2013,CH de Mulhouse ( Hasenrain),PEDIATRIE NEONATOLOGIE,19,0,36,55,11,2,0
31/03/2013,CH de Mulhouse (Emile Muller-Moenschberg,URGENCES,0,22,107,129,12,12,2
31/03/2013,CH de Saverne,S.A.U. (ADULTES),0,7,36,43,7,1,0
31/03/2013,CH de Saverne,PEDIATRIE,9,0,26,35,5,0,0
31/03/2013,CH de Sélestat,Acceuil des urgences,1,10,73,84,9,4,1
31/03/2013,CH de Thann,Urgences,0,3,30,33,1,1,5
31/03/2013,CH de Wissembourg,Urgences ,2,6,37,45,9,0,3
31/03/2013,CHU de Strasbourg (Hôp. Civil),Urgences Médico-Chirurgicales NHC,0,17,82,99,36,1,0
31/03/2013,CHU de Strasbourg(Hautepierre),Urgences chirurgicales pédiatriques,15,0,66,81,17,16,0
31/03/2013,CHU de Strasbourg(Hautepierre),Gynéco-Obstétrique (HTP),0,0,29,29,9,0,0
31/03/2013,CHU de Strasbourg(Hautepierre),Urgences Adulte HTP,0,18,87,105,38,0,0
31/03/2013,CHU de Strasbourg(Hautepierre),Urgences chirurgicales pédiatriques,5,0,34,39,7,6,0
31/03/2013,Clinique des 3 Frontières,UPATOU (Structure des urgences),1,6,38,45,5,0,1
31/03/2013,Clinique des Diaconesses,SOS Main,0,1,19,20,0,0,0
31/03/2013,Clinique Ste Odile (Strasbourg,UPATOU,1,1,80,82,2,4,2
31/03/2013,CMCO,GYNECO-OBSTETRIQUE,0,0,0,0,0,0,0
31/03/2013,SIHCUS/CMCO,GYNECOLOGIE ET OBSTETRIQUE - CMCO,0,0,0,0,0,0,0
30/03/2013,CCOM,CCOM Chirurgie,0,0,19,19,1,0,0
30/03/2013,CH Altkirch,Upatou,0,3,29,32,4,2,0
30/03/2013,CH de Colmar (CMC Le Parc),SAU Le Parc,58,0,16,74,18,0,0
30/03/2013,CH de Colmar (Louis Pasteur),SAU Pasteur,0,23,116,139,22,7,0
30/03/2013,CH de Guebwiller,UHTCD,0,8,42,50,8,0,1
30/03/2013,CH de Mulhouse ( Hasenrain),PEDIATRIE NEONATOLOGIE,17,0,34,51,4,3,0
30/03/2013,CH de Mulhouse (Emile Muller-Moenschberg,URGENCES,1,31,113,145,20,5,2
30/03/2013,CH de Saverne,S.A.U. (ADULTES),0,8,42,50,12,3,1
30/03/2013,CH de Saverne,PEDIATRIE,9,0,24,33,6,1,0
30/03/2013,CH de Sélestat,Acceuil des urgences,0,15,79,94,20,5,2
30/03/2013,CH de Thann,Urgences,1,5,45,51,4,0,1
30/03/2013,CH de Wissembourg,Urgences ,0,6,15,21,6,0,0
30/03/2013,CHU de Strasbourg (Hôp. Civil),Urgences Médico-Chirurgicales NHC,0,33,107,140,50,4,1
30/03/2013,CHU de Strasbourg(Hautepierre),Urgences chirurgicales pédiatriques,15,0,65,80,13,13,0
30/03/2013,CHU de Strasbourg(Hautepierre),Gynéco-Obstétrique (HTP),0,0,42,42,16,0,0
30/03/2013,CHU de Strasbourg(Hautepierre),Urgences Adulte HTP,0,22,70,92,25,0,0
30/03/2013,CHU de Strasbourg(Hautepierre),Urgences chirurgicales pédiatriques,3,0,43,46,7,6,0
30/03/2013,Clinique des 3 Frontières,UPATOU (Structure des urgences),1,3,54,58,3,0,0
30/03/2013,Clinique des Diaconesses,SOS Main,0,2,32,34,2,0,3
30/03/2013,Clinique Ste Odile (Strasbourg,UPATOU,2,6,82,90,2,5,2
30/03/2013,CMCO,GYNECO-OBSTETRIQUE,0,0,0,0,0,0,0
30/03/2013,SIHCUS/CMCO,GYNECOLOGIE ET OBSTETRIQUE - CMCO,0,0,0,0,0,0,0
29/03/2013,CCOM,CCOM Chirurgie,0,1,21,22,6,0,0
29/03/2013,CH Altkirch,Upatou,0,7,46,53,6,1,2
29/03/2013,CH de Colmar (CMC Le Parc),SAU Le Parc,13,0,44,57,5,0,0
29/03/2013,CH de Colmar (Louis Pasteur),SAU Pasteur,0,18,92,110,24,9,4
29/03/2013,CH de Guebwiller,UHTCD,0,3,27,30,2,0,1
29/03/2013,CH de Mulhouse ( Hasenrain),PEDIATRIE NEONATOLOGIE,16,0,30,46,7,2,0
29/03/2013,CH de Mulhouse (Emile Muller-Moenschberg,URGENCES,1,16,117,134,9,9,1
29/03/2013,CH de Saverne,S.A.U. (ADULTES),0,11,46,57,10,3,1
29/03/2013,CH de Saverne,PEDIATRIE,10,0,20,30,3,0,0
29/03/2013,CH de Sélestat,Acceuil des urgences,1,12,87,100,17,4,3
29/03/2013,CH de Thann,Urgences,0,6,36,42,2,2,2
29/03/2013,CH de Wissembourg,Urgences ,1,6,33,40,7,0,0
29/03/2013,CHU de Strasbourg (Hôp. Civil),Urgences Médico-Chirurgicales NHC,0,20,84,104,39,7,1
29/03/2013,CHU de Strasbourg(Hautepierre),Urgences chirurgicales pédiatriques,14,0,59,73,11,11,0
29/03/2013,CHU de Strasbourg(Hautepierre),Gynéco-Obstétrique (HTP),0,0,37,37,9,0,0
29/03/2013,CHU de Strasbourg(Hautepierre),Urgences Adulte HTP,0,14,72,86,29,0,0
29/03/2013,CHU de Strasbourg(Hautepierre),Urgences chirurgicales pédiatriques,0,0,39,39,9,8,0
29/03/2013,Clinique des 3 Frontières,UPATOU (Structure des urgences),0,4,27,31,6,0,0
29/03/2013,Clinique des Diaconesses,SOS Main,0,1,24,25,7,0,0
29/03/2013,Clinique Ste Odile (Strasbourg,UPATOU,1,4,93,98,2,7,1
29/03/2013,CMCO,GYNECO-OBSTETRIQUE,0,0,0,0,0,0,0
29/03/2013,SIHCUS/CMCO,GYNECOLOGIE ET OBSTETRIQUE - CMCO,0,0,0,0,0,0,0
28/03/2013,CCOM,CCOM Chirurgie,0,2,20,22,1,0,0
28/03/2013,CH Altkirch,Upatou,0,10,44,54,9,0,2
28/03/2013,CH de Colmar (CMC Le Parc),SAU Le Parc,11,0,56,67,0,9,0
28/03/2013,CH de Colmar (Louis Pasteur),SAU Pasteur,0,24,99,123,36,8,2
28/03/2013,CH de Guebwiller,UHTCD,0,4,35,39,2,1,1
28/03/2013,CH de Mulhouse ( Hasenrain),PEDIATRIE NEONATOLOGIE,11,0,26,37,8,3,0
28/03/2013,CH de Mulhouse (Emile Muller-Moenschberg,URGENCES,0,18,112,130,7,13,4
28/03/2013,CH de Saverne,S.A.U. (ADULTES),0,13,57,70,10,8,1
28/03/2013,CH de Saverne,PEDIATRIE,7,0,18,25,3,0,0
28/03/2013,CH de Sélestat,Acceuil des urgences,1,7,74,82,13,5,0
28/03/2013,CH de Thann,Urgences,1,8,29,38,3,1,2
28/03/2013,CHU de Strasbourg (Hôp. Civil),Urgences Médico-Chirurgicales NHC,0,21,69,90,52,1,1
28/03/2013,CHU de Strasbourg(Hautepierre),Urgences chirurgicales pédiatriques,11,0,53,64,6,6,0
28/03/2013,CHU de Strasbourg(Hautepierre),Gynéco-Obstétrique (HTP),0,0,27,27,14,0,0
28/03/2013,CHU de Strasbourg(Hautepierre),Urgences Adulte HTP,1,17,73,91,37,0,1
28/03/2013,CHU de Strasbourg(Hautepierre),Urgences chirurgicales pédiatriques,4,0,54,58,1,1,0
28/03/2013,Clinique des 3 Frontières,UPATOU (Structure des urgences),1,6,45,52,7,0,0
28/03/2013,Clinique des Diaconesses,SOS Main,0,0,41,41,12,0,1
28/03/2013,Clinique Ste Odile (Strasbourg,UPATOU,1,4,61,66,4,9,3
28/03/2013,CMCO,GYNECO-OBSTETRIQUE,0,0,0,0,0,0,0
28/03/2013,SIHCUS/CMCO,GYNECOLOGIE ET OBSTETRIQUE - CMCO,0,0,0,0,0,0,0
27/03/2013,CCOM,CCOM Chirurgie,0,1,26,27,3,0,0
27/03/2013,CH Altkirch,Upatou,0,2,33,35,6,1,1
27/03/2013,CH de Colmar (CMC Le Parc),SAU Le Parc,3,0,45,48,4,0,0
27/03/2013,CH de Colmar (Louis Pasteur),SAU Pasteur,0,20,81,101,22,11,2
27/03/2013,CH de Guebwiller,UHTCD,0,2,34,36,1,3,1
27/03/2013,CH de Mulhouse ( Hasenrain),PEDIATRIE NEONATOLOGIE,16,0,15,31,3,2,0
27/03/2013,CH de Mulhouse (Emile Muller-Moenschberg,URGENCES,1,16,97,114,19,9,3
27/03/2013,CH de Saverne,S.A.U. (ADULTES),0,10,34,44,9,4,0
27/03/2013,CH de Saverne,PEDIATRIE,5,0,13,18,2,3,0
27/03/2013,CH de Sélestat,Acceuil des urgences,2,10,52,64,11,3,1
27/03/2013,CH de Thann,Urgences,0,5,22,27,2,1,0
27/03/2013,CHU de Strasbourg (Hôp. Civil),Urgences Médico-Chirurgicales NHC,0,19,60,79,49,2,1
27/03/2013,CHU de Strasbourg(Hautepierre),Urgences chirurgicales pédiatriques,1,0,54,55,5,5,0
27/03/2013,CHU de Strasbourg(Hautepierre),Urgences Adulte HTP,0,13,77,90,39,0,0
27/03/2013,CHU de Strasbourg(Hautepierre),Urgences chirurgicales pédiatriques,16,0,44,60,7,7,0
27/03/2013,CHU de Strasbourg(Hautepierre),Gynéco-Obstétrique (HTP),0,0,22,22,11,0,0
27/03/2013,Clinique des 3 Frontières,UPATOU (Structure des urgences),0,3,42,45,2,0,0
27/03/2013,Clinique des Diaconesses,SOS Main,0,0,32,32,7,0,0
27/03/2013,Clinique Ste Odile (Strasbourg,UPATOU,0,7,63,70,1,7,1
27/03/2013,CMCO,GYNECO-OBSTETRIQUE,0,0,0,0,0,0,0
27/03/2013,SIHCUS/CMCO,GYNECOLOGIE ET OBSTETRIQUE - CMCO,0,0,0,0,0,0,0
26/03/2013,CCOM,CCOM Chirurgie,0,2,12,14,1,0,0
26/03/2013,CH Altkirch,Upatou,0,5,32,37,3,0,0
26/03/2013,CH de Colmar (CMC Le Parc),SAU Le Parc,5,0,48,53,11,0,0
26/03/2013,CH de Colmar (Louis Pasteur),SAU Pasteur,0,20,88,108,12,11,0
26/03/2013,CH de Guebwiller,UHTCD,1,8,24,33,4,3,0
26/03/2013,CH de Mulhouse ( Hasenrain),PEDIATRIE NEONATOLOGIE,4,0,22,26,9,1,0
26/03/2013,CH de Mulhouse (Emile Muller-Moenschberg,URGENCES,0,23,86,109,12,16,6
26/03/2013,CH de Saverne,S.A.U. (ADULTES),0,8,33,41,3,5,2
26/03/2013,CH de Saverne,PEDIATRIE,3,0,24,27,5,0,0
26/03/2013,CH de Sélestat,Acceuil des urgences,1,19,65,85,22,7,3
26/03/2013,CH de Thann,Urgences,0,6,31,37,4,1,1
26/03/2013,CH de Wissembourg,Urgences ,0,6,15,21,6,0,0
26/03/2013,CHU de Strasbourg (Hôp. Civil),Urgences Médico-Chirurgicales NHC,0,16,52,68,41,5,0
26/03/2013,CHU de Strasbourg(Hautepierre),Urgences Adulte HTP,0,9,80,89,36,0,0
26/03/2013,CHU de Strasbourg(Hautepierre),Urgences chirurgicales pédiatriques,23,0,48,71,9,8,0
26/03/2013,CHU de Strasbourg(Hautepierre),Gynéco-Obstétrique (HTP),0,0,34,34,15,0,0
26/03/2013,CHU de Strasbourg(Hautepierre),Urgences chirurgicales pédiatriques,3,0,39,42,4,3,0
26/03/2013,Clinique des 3 Frontières,UPATOU (Structure des urgences),0,2,40,42,9,0,1
26/03/2013,Clinique des Diaconesses,SOS Main,0,1,32,33,0,0,0
26/03/2013,Clinique Ste Odile (Strasbourg,UPATOU,0,4,72,76,0,9,5
26/03/2013,CMCO,GYNECO-OBSTETRIQUE,0,0,0,0,0,0,0
26/03/2013,SIHCUS/CMCO,GYNECOLOGIE ET OBSTETRIQUE - CMCO,0,0,0,0,0,0,0
25/03/2013,CCOM,CCOM Chirurgie,0,1,28,29,1,0,0
25/03/2013,CH Altkirch,Upatou,1,1,26,28,4,0,0
25/03/2013,CH de Colmar (CMC Le Parc),SAU Le Parc,6,0,54,60,13,0,0
25/03/2013,CH de Colmar (Louis Pasteur),SAU Pasteur,0,33,102,135,23,11,0
25/03/2013,CH de Guebwiller,UHTCD,0,4,40,44,2,1,0
25/03/2013,CH de Saverne,S.A.U. (ADULTES),0,15,48,63,14,6,1
25/03/2013,CH de Saverne,PEDIATRIE,3,0,22,25,3,0,0
25/03/2013,CH de Sélestat,Acceuil des urgences,0,12,89,101,13,3,0
25/03/2013,CH de Thann,Urgences,1,5,47,53,3,0,2
25/03/2013,CH de Wissembourg,Urgences ,0,5,38,43,10,4,0
25/03/2013,CHU de Strasbourg (Hôp. Civil),Urgences Médico-Chirurgicales NHC,0,19,68,87,52,6,1
25/03/2013,CHU de Strasbourg(Hautepierre),Urgences chirurgicales pédiatriques,25,0,33,58,9,9,0
25/03/2013,CHU de Strasbourg(Hautepierre),Gynéco-Obstétrique (HTP),0,0,32,32,12,0,0
25/03/2013,CHU de Strasbourg(Hautepierre),Urgences Adulte HTP,0,29,88,117,59,0,1
25/03/2013,CHU de Strasbourg(Hautepierre),Urgences chirurgicales pédiatriques,3,0,54,57,4,5,0
25/03/2013,Clinique des 3 Frontières,UPATOU (Structure des urgences),0,6,41,47,8,0,0
25/03/2013,Clinique des Diaconesses,SOS Main,0,8,43,51,2,0,0
25/03/2013,Clinique Ste Odile (Strasbourg,UPATOU,1,2,76,79,2,6,2
25/03/2013,CMCO,GYNECO-OBSTETRIQUE,0,0,0,0,0,0,0
25/03/2013,SIHCUS/CMCO,GYNECOLOGIE ET OBSTETRIQUE - CMCO,0,0,0,0,0,0,0
24/03/2013,CCOM,CCOM Chirurgie,0,2,24,26,2,0,0
24/03/2013,CH Altkirch,Upatou,0,7,34,41,3,0,2
24/03/2013,CH de Colmar (CMC Le Parc),SAU Le Parc,10,0,50,60,11,0,1
24/03/2013,CH de Colmar (Louis Pasteur),SAU Pasteur,0,15,97,112,10,9,0
24/03/2013,CH de Guebwiller,UHTCD,0,5,32,37,1,1,1
24/03/2013,CH de Mulhouse ( Hasenrain),PEDIATRIE NEONATOLOGIE,11,0,35,46,8,1,0
24/03/2013,CH de Mulhouse (Emile Muller-Moenschberg,URGENCES,2,13,106,121,18,4,1
24/03/2013,CH de Saverne,S.A.U. (ADULTES),0,6,34,40,6,1,1
24/03/2013,CH de Saverne,PEDIATRIE,10,0,26,36,6,1,0
24/03/2013,CH de Sélestat,Acceuil des urgences,0,6,97,103,9,4,1
24/03/2013,CH de Thann,Urgences,0,3,36,39,3,1,2
24/03/2013,CH de Wissembourg,Urgences ,1,2,27,30,3,1,1
24/03/2013,CHU de Strasbourg (Hôp. Civil),Urgences Médico-Chirurgicales NHC,0,15,66,81,38,0,1
24/03/2013,CHU de Strasbourg(Hautepierre),Urgences chirurgicales pédiatriques,2,0,50,52,5,5,0
24/03/2013,CHU de Strasbourg(Hautepierre),Urgences chirurgicales pédiatriques,20,0,53,73,14,14,0
24/03/2013,CHU de Strasbourg(Hautepierre),Gynéco-Obstétrique (HTP),0,0,31,31,13,0,0
24/03/2013,CHU de Strasbourg(Hautepierre),Urgences Adulte HTP,0,10,77,87,19,0,0
24/03/2013,Clinique des 3 Frontières,UPATOU (Structure des urgences),0,4,42,46,6,0,0
24/03/2013,Clinique des Diaconesses,SOS Main,0,0,16,16,1,0,1
24/03/2013,Clinique Ste Odile (Strasbourg,UPATOU,0,7,81,88,3,6,2
24/03/2013,CMCO,GYNECO-OBSTETRIQUE,0,0,0,0,0,0,0
24/03/2013,SIHCUS/CMCO,GYNECOLOGIE ET OBSTETRIQUE - CMCO,0,0,0,0,0,0,0
23/03/2013,CCOM,CCOM Chirurgie,0,0,23,23,0,0,0
23/03/2013,CH Altkirch,Upatou,0,10,29,39,3,1,2
23/03/2013,CH de Colmar (CMC Le Parc),SAU Le Parc,5,0,54,59,6,0,0
23/03/2013,CH de Colmar (Louis Pasteur),SAU Pasteur,0,26,124,150,31,11,8
23/03/2013,CH de Guebwiller,UHTCD,0,4,36,40,3,1,1
23/03/2013,CH de Mulhouse ( Hasenrain),PEDIATRIE NEONATOLOGIE,14,0,23,37,1,1,0
23/03/2013,CH de Mulhouse (Emile Muller-Moenschberg,URGENCES,0,20,121,141,9,10,0
23/03/2013,CH de Saverne,PEDIATRIE,6,0,27,33,5,2,0
23/03/2013,CH de Saverne,S.A.U. (ADULTES),0,7,34,41,6,4,0
23/03/2013,CH de Sélestat,Acceuil des urgences,1,14,68,83,11,4,0
23/03/2013,CH de Thann,Urgences,0,12,37,49,2,1,4
23/03/2013,CH de Wissembourg,Urgences ,2,3,25,30,3,1,0
23/03/2013,CHU de Strasbourg (Hôp. Civil),Urgences Médico-Chirurgicales NHC,0,20,82,102,43,2,1
23/03/2013,CHU de Strasbourg(Hautepierre),Urgences chirurgicales pédiatriques,18,0,56,74,14,13,0
23/03/2013,CHU de Strasbourg(Hautepierre),Gynéco-Obstétrique (HTP),2,0,26,28,10,0,0
23/03/2013,CHU de Strasbourg(Hautepierre),Urgences Adulte HTP,0,19,91,110,32,0,0
23/03/2013,CHU de Strasbourg(Hautepierre),Urgences chirurgicales pédiatriques,2,0,42,44,6,6,0
23/03/2013,Clinique des 3 Frontières,UPATOU (Structure des urgences),1,7,46,54,9,0,0
23/03/2013,Clinique des Diaconesses,SOS Main,0,2,28,30,1,0,0
23/03/2013,Clinique Ste Odile (Strasbourg,UPATOU,1,7,79,87,2,4,1
23/03/2013,CMCO,GYNECO-OBSTETRIQUE,0,0,0,0,0,0,0
23/03/2013,SIHCUS/CMCO,GYNECOLOGIE ET OBSTETRIQUE - CMCO,0,0,0,0,0,0,0
22/03/2013,CCOM,CCOM Chirurgie,0,2,24,26,5,0,0
22/03/2013,CH Altkirch,Upatou,0,5,39,44,6,1,0
22/03/2013,CH de Colmar (CMC Le Parc),SAU Le Parc,7,0,50,57,7,0,0
22/03/2013,CH de Colmar (Louis Pasteur),SAU Pasteur,0,21,90,111,15,10,0
22/03/2013,CH de Guebwiller,UHTCD,0,3,33,36,0,1,2
22/03/2013,CH de Mulhouse ( Hasenrain),PEDIATRIE NEONATOLOGIE,16,0,38,54,9,4,0
22/03/2013,CH de Mulhouse (Emile Muller-Moenschberg,URGENCES,1,13,102,116,11,8,4
22/03/2013,CH de Saverne,S.A.U. (ADULTES),0,10,44,54,8,1,0
22/03/2013,CH de Saverne,PEDIATRIE,4,0,15,19,3,0,0
22/03/2013,CH de Sélestat,Acceuil des urgences,3,18,71,92,22,4,2
22/03/2013,CH de Thann,Urgences,0,12,30,42,3,0,3
22/03/2013,CH de Wissembourg,Urgences ,0,5,28,33,4,0,0
22/03/2013,CHU de Strasbourg (Hôp. Civil),Urgences Médico-Chirurgicales NHC,0,20,62,82,45,1,3
22/03/2013,CHU de Strasbourg(Hautepierre),Gynéco-Obstétrique (HTP),0,0,22,22,11,0,0
22/03/2013,CHU de Strasbourg(Hautepierre),Urgences chirurgicales pédiatriques,3,0,40,43,4,5,0
22/03/2013,CHU de Strasbourg(Hautepierre),Urgences Adulte HTP,0,27,78,105,38,0,0
22/03/2013,CHU de Strasbourg(Hautepierre),Urgences chirurgicales pédiatriques,16,0,45,61,13,12,0
22/03/2013,Clinique des 3 Frontières,UPATOU (Structure des urgences),0,6,30,36,2,1,2
22/03/2013,Clinique Ste Odile (Strasbourg,UPATOU,0,1,62,63,4,6,0
22/03/2013,CMCO,GYNECO-OBSTETRIQUE,0,0,0,0,0,0,0
22/03/2013,SIHCUS/CMCO,GYNECOLOGIE ET OBSTETRIQUE - CMCO,0,0,0,0,0,0,0
21/03/2013,CCOM,CCOM Chirurgie,0,0,29,29,3,0,0
21/03/2013,CH Altkirch,Upatou,1,3,34,38,5,0,1
21/03/2013,CH de Colmar (CMC Le Parc),SAU Le Parc,8,0,58,66,8,0,0
21/03/2013,CH de Colmar (Louis Pasteur),SAU Pasteur,0,28,102,130,12,14,0
21/03/2013,CH de Guebwiller,UHTCD,1,11,35,47,4,3,1
21/03/2013,CH de Mulhouse ( Hasenrain),PEDIATRIE NEONATOLOGIE,13,0,18,31,4,2,0
21/03/2013,CH de Mulhouse (Emile Muller-Moenschberg,URGENCES,2,22,89,113,13,15,1
21/03/2013,CH de Saverne,S.A.U. (ADULTES),0,8,38,46,10,4,0
21/03/2013,CH de Saverne,PEDIATRIE,4,0,20,24,1,0,0
21/03/2013,CH de Sélestat,Acceuil des urgences,1,14,52,67,14,3,2
21/03/2013,CH de Thann,Urgences,0,8,34,42,3,1,3
21/03/2013,CHU de Strasbourg (Hôp. Civil),Urgences Médico-Chirurgicales NHC,0,18,57,75,39,9,1
21/03/2013,CHU de Strasbourg(Hautepierre),Gynéco-Obstétrique (HTP),0,0,28,28,12,0,0
21/03/2013,CHU de Strasbourg(Hautepierre),Urgences chirurgicales pédiatriques,2,0,64,66,3,3,0
21/03/2013,CHU de Strasbourg(Hautepierre),Urgences chirurgicales pédiatriques,17,0,52,69,15,14,0
21/03/2013,CHU de Strasbourg(Hautepierre),Urgences Adulte HTP,0,12,91,103,33,0,0
21/03/2013,Clinique des 3 Frontières,UPATOU (Structure des urgences),2,4,32,38,4,0,0
21/03/2013,Clinique des Diaconesses,SOS Main,0,0,42,42,0,13,0
21/03/2013,Clinique Ste Odile (Strasbourg,UPATOU,0,6,51,57,3,5,2
21/03/2013,CMCO,GYNECO-OBSTETRIQUE,0,0,0,0,0,0,0
21/03/2013,SIHCUS/CMCO,GYNECOLOGIE ET OBSTETRIQUE - CMCO,0,0,0,0,0,0,0
20/03/2013,CCOM,CCOM Chirurgie,0,0,25,25,2,0,0
20/03/2013,CH Altkirch,Upatou,0,3,40,43,2,1,1
20/03/2013,CH de Colmar (CMC Le Parc),SAU Le Parc,8,0,30,38,3,0,0
20/03/2013,CH de Colmar (Louis Pasteur),SAU Pasteur,0,23,79,102,18,6,1
20/03/2013,CH de Guebwiller,UHTCD,0,7,32,39,4,3,1
20/03/2013,CH de Mulhouse ( Hasenrain),PEDIATRIE NEONATOLOGIE,12,0,18,30,11,1,0
20/03/2013,CH de Mulhouse (Emile Muller-Moenschberg,URGENCES,0,12,102,114,10,13,3
20/03/2013,CH de Saverne,S.A.U. (ADULTES),0,13,30,43,11,2,2
20/03/2013,CH de Saverne,PEDIATRIE,6,0,23,29,2,1,0
20/03/2013,CH de Sélestat,Acceuil des urgences,2,5,50,57,8,7,0
20/03/2013,CH de Thann,Urgences,2,1,40,43,1,0,1
20/03/2013,CHU de Strasbourg (Hôp. Civil),Urgences Médico-Chirurgicales NHC,0,13,62,75,43,3,0
20/03/2013,CHU de Strasbourg(Hautepierre),Urgences chirurgicales pédiatriques,0,0,47,47,8,8,0
20/03/2013,CHU de Strasbourg(Hautepierre),Urgences chirurgicales pédiatriques,17,0,38,55,13,12,0
20/03/2013,CHU de Strasbourg(Hautepierre),Gynéco-Obstétrique (HTP),0,0,20,20,9,0,0
20/03/2013,CHU de Strasbourg(Hautepierre),Urgences Adulte HTP,0,14,78,92,35,0,0
20/03/2013,Clinique des 3 Frontières,UPATOU (Structure des urgences),2,6,36,44,8,0,1
20/03/2013,Clinique Ste Odile (Strasbourg,UPATOU,0,3,60,63,1,4,0
20/03/2013,CMCO,GYNECO-OBSTETRIQUE,0,0,0,0,0,0,0
20/03/2013,SIHCUS/CMCO,GYNECOLOGIE ET OBSTETRIQUE - CMCO,0,0,0,0,0,0,0
30/06/2013,CCOM,CCOM Chirurgie,0,0,32,32,4,0,0
30/06/2013,CH Altkirch,Upatou,0,4,40,44,5,2,0
30/06/2013,CH de Colmar (CMC Le Parc),SAU Le Parc,5,0,42,47,6,0,0
30/06/2013,CH de Colmar (Louis Pasteur),SAU Pasteur,0,18,92,110,16,9,0
30/06/2013,CH de Guebwiller,UHTCD,0,0,0,0,0,4,1
30/06/2013,CH de Mulhouse ( Hasenrain),PEDIATRIE NEONATOLOGIE,10,0,38,48,4,1,0
30/06/2013,CH de Mulhouse (Emile Muller-Moenschberg,URGENCES,1,14,152,167,21,11,3
30/06/2013,CH de Saverne,PEDIATRIE,5,0,24,29,0,1,0
30/06/2013,CH de Saverne,S.A.U. (ADULTES),0,7,44,51,2,5,0
30/06/2013,CH de Sélestat,Acceuil des urgences,2,8,84,94,12,1,2
30/06/2013,CH de Thann,Urgences,0,6,46,52,3,0,0
30/06/2013,CHU de Strasbourg (Hôp. Civil),Urgences Médico-Chirurgicales NHC,0,13,77,90,35,1,0
30/06/2013,CHU de Strasbourg(Hautepierre),Urgences chirurgicales pédiatriques,9,0,28,37,3,2,0
30/06/2013,CHU de Strasbourg(Hautepierre),Urgences Adulte HTP,0,10,77,87,30,0,0
30/06/2013,CHU de Strasbourg(Hautepierre),Gynéco-Obstétrique (HTP),0,0,20,20,8,0,0
30/06/2013,CHU de Strasbourg(Hautepierre),Urgences chirurgicales pédiatriques,3,0,58,61,4,4,0
30/06/2013,Clinique des 3 Frontières,UPATOU (Structure des urgences),3,5,46,54,1,0,0
30/06/2013,Clinique Ste Odile (Strasbourg,UPATOU,0,5,83,88,3,6,1
30/06/2013,CMCO,GYNECO-OBSTETRIQUE,0,0,0,0,0,0,0
30/06/2013,SIHCUS/CMCO,GYNECOLOGIE ET OBSTETRIQUE - CMCO,0,0,0,0,0,0,0
29/06/2013,CCOM,CCOM Chirurgie,0,3,24,27,9,0,0
29/06/2013,CH Altkirch,Upatou,0,4,47,51,6,0,3
29/06/2013,CH de Colmar (CMC Le Parc),SAU Le Parc,6,0,48,54,0,8,0
29/06/2013,CH de Colmar (Louis Pasteur),SAU Pasteur,0,23,100,123,17,14,3
29/06/2013,CH de Guebwiller,UHTCD,1,0,28,29,1,0,6
29/06/2013,CH de Mulhouse ( Hasenrain),PEDIATRIE NEONATOLOGIE,11,0,38,49,13,1,0
29/06/2013,CH de Mulhouse (Emile Muller-Moenschberg,URGENCES,0,17,115,132,17,10,3
29/06/2013,CH de Saverne,S.A.U. (ADULTES),0,9,38,47,10,2,0
29/06/2013,CH de Saverne,PEDIATRIE,3,0,15,18,1,0,0
29/06/2013,CH de Sélestat,Acceuil des urgences,2,14,81,97,10,5,1
29/06/2013,CH de Thann,Urgences,2,3,46,51,3,2,0
29/06/2013,CHU de Strasbourg (Hôp. Civil),Urgences Médico-Chirurgicales NHC,0,17,78,95,39,0,1
29/06/2013,CHU de Strasbourg(Hautepierre),Urgences chirurgicales pédiatriques,10,0,40,50,8,8,0
29/06/2013,CHU de Strasbourg(Hautepierre),Gynéco-Obstétrique (HTP),0,0,18,18,5,0,0
29/06/2013,CHU de Strasbourg(Hautepierre),Urgences chirurgicales pédiatriques,4,0,45,49,3,3,0
29/06/2013,CHU de Strasbourg(Hautepierre),Urgences Adulte HTP,0,17,67,84,29,0,0
29/06/2013,Clinique des 3 Frontières,UPATOU (Structure des urgences),0,4,59,63,7,0,0
29/06/2013,Clinique Ste Odile (Strasbourg,UPATOU,1,3,55,59,2,8,1
29/06/2013,CMCO,GYNECO-OBSTETRIQUE,0,0,0,0,0,0,0
29/06/2013,SIHCUS/CMCO,GYNECOLOGIE ET OBSTETRIQUE - CMCO,0,0,0,0,0,0,0
28/06/2013,CCOM,CCOM Chirurgie,0,2,30,32,6,0,0
28/06/2013,CH Altkirch,Upatou,0,7,34,41,3,2,0
28/06/2013,CH de Colmar (CMC Le Parc),SAU Le Parc,39,0,9,48,9,0,1
28/06/2013,CH de Colmar (Louis Pasteur),SAU Pasteur,0,21,102,123,24,5,4
28/06/2013,CH de Guebwiller,UHTCD,0,2,47,49,2,4,0
28/06/2013,CH de Mulhouse ( Hasenrain),PEDIATRIE NEONATOLOGIE,11,0,19,30,7,1,0
28/06/2013,CH de Mulhouse (Emile Muller-Moenschberg,URGENCES,1,16,94,111,12,3,5
28/06/2013,CH de Saverne,PEDIATRIE,3,0,13,16,0,1,0
28/06/2013,CH de Saverne,S.A.U. (ADULTES),0,8,33,41,10,2,0
28/06/2013,CH de Sélestat,Acceuil des urgences,1,15,63,79,18,6,1
28/06/2013,CH de Thann,Urgences,0,7,41,48,1,2,2
28/06/2013,CHU de Strasbourg (Hôp. Civil),Urgences Médico-Chirurgicales NHC,0,18,56,74,42,2,1
28/06/2013,CHU de Strasbourg(Hautepierre),Gynéco-Obstétrique (HTP),1,0,17,18,11,0,0
28/06/2013,CHU de Strasbourg(Hautepierre),Urgences Adulte HTP,0,7,57,64,23,0,0
28/06/2013,CHU de Strasbourg(Hautepierre),Urgences chirurgicales pédiatriques,6,0,41,47,3,4,0
28/06/2013,CHU de Strasbourg(Hautepierre),Urgences chirurgicales pédiatriques,15,0,32,47,6,6,0
28/06/2013,Clinique des 3 Frontières,UPATOU (Structure des urgences),1,4,38,43,6,0,0
28/06/2013,Clinique Ste Odile (Strasbourg,UPATOU,0,5,62,67,4,11,1
28/06/2013,CMCO,GYNECO-OBSTETRIQUE,0,0,0,0,0,0,0
28/06/2013,SIHCUS/CMCO,GYNECOLOGIE ET OBSTETRIQUE - CMCO,0,0,0,0,0,0,0
27/06/2013,CCOM,CCOM Chirurgie,0,1,27,28,2,0,0
27/06/2013,CH Altkirch,Upatou,0,3,29,32,1,1,1
27/06/2013,CH de Colmar (CMC Le Parc),SAU Le Parc,6,0,36,42,9,0,0
27/06/2013,CH de Colmar (Louis Pasteur),SAU Pasteur,0,13,97,110,17,8,0
27/06/2013,CH de Guebwiller,UHTCD,0,2,43,45,0,4,2
27/06/2013,CH de Mulhouse ( Hasenrain),PEDIATRIE NEONATOLOGIE,7,0,34,41,3,4,0
27/06/2013,CH de Mulhouse (Emile Muller-Moenschberg,URGENCES,0,15,100,115,6,11,4
27/06/2013,CH de Saverne,S.A.U. (ADULTES),0,9,37,46,6,2,0
27/06/2013,CH de Saverne,PEDIATRIE,5,0,17,22,1,0,0
27/06/2013,CH de Sélestat,Acceuil des urgences,0,12,61,73,21,5,1
27/06/2013,CH de Thann,Urgences,1,5,23,29,4,0,2
27/06/2013,CHU de Strasbourg (Hôp. Civil),Urgences Médico-Chirurgicales NHC,0,20,44,64,36,9,1
27/06/2013,CHU de Strasbourg(Hautepierre),Urgences chirurgicales pédiatriques,1,0,47,48,3,3,0
27/06/2013,CHU de Strasbourg(Hautepierre),Urgences Adulte HTP,0,12,68,80,27,0,0
27/06/2013,CHU de Strasbourg(Hautepierre),Urgences chirurgicales pédiatriques,13,0,40,53,6,6,0
27/06/2013,CHU de Strasbourg(Hautepierre),Gynéco-Obstétrique (HTP),0,0,24,24,8,0,0
27/06/2013,Clinique des 3 Frontières,UPATOU (Structure des urgences),1,1,45,47,4,0,0
27/06/2013,Clinique Ste Odile (Strasbourg,UPATOU,1,5,69,75,2,5,4
27/06/2013,CMCO,GYNECO-OBSTETRIQUE,0,0,0,0,0,0,0
27/06/2013,SIHCUS/CMCO,GYNECOLOGIE ET OBSTETRIQUE - CMCO,0,0,0,0,0,0,0
26/06/2013,CCOM,CCOM Chirurgie,0,1,30,31,7,0,0
26/06/2013,CH Altkirch,Upatou,1,5,30,36,6,0,1
26/06/2013,CH de Colmar (CMC Le Parc),SAU Le Parc,5,0,29,34,10,0,0
26/06/2013,CH de Colmar (Louis Pasteur),SAU Pasteur,0,21,88,109,21,10,0
26/06/2013,CH de Guebwiller,UHTCD,0,6,34,40,2,5,2
26/06/2013,CH de Mulhouse ( Hasenrain),PEDIATRIE NEONATOLOGIE,8,0,24,32,5,0,0
26/06/2013,CH de Mulhouse (Emile Muller-Moenschberg,URGENCES,3,21,124,148,10,13,6
26/06/2013,CH de Saverne,S.A.U. (ADULTES),0,16,41,57,11,3,0
26/06/2013,CH de Saverne,PEDIATRIE,3,0,13,16,3,0,0
26/06/2013,CH de Sélestat,Acceuil des urgences,0,12,68,80,11,3,0
26/06/2013,CH de Thann,Urgences,0,5,43,48,3,0,1
26/06/2013,CH de Wissembourg,Urgences ,0,4,29,33,7,0,0
26/06/2013,CHU de Strasbourg (Hôp. Civil),Urgences Médico-Chirurgicales NHC,0,14,60,74,38,6,1
26/06/2013,CHU de Strasbourg(Hautepierre),Urgences chirurgicales pédiatriques,0,0,48,48,6,7,0
26/06/2013,CHU de Strasbourg(Hautepierre),Urgences Adulte HTP,0,13,66,79,28,0,0
26/06/2013,CHU de Strasbourg(Hautepierre),Urgences chirurgicales pédiatriques,12,0,47,59,4,3,0
26/06/2013,CHU de Strasbourg(Hautepierre),Gynéco-Obstétrique (HTP),1,0,21,22,11,0,0
26/06/2013,Clinique des 3 Frontières,UPATOU (Structure des urgences),1,4,50,55,8,0,1
26/06/2013,Clinique des Diaconesses,SOS Main,0,4,32,36,11,0,0
26/06/2013,Clinique Ste Odile (Strasbourg,UPATOU,0,2,62,64,2,1,1
26/06/2013,CMCO,GYNECO-OBSTETRIQUE,0,0,0,0,0,0,0
26/06/2013,SIHCUS/CMCO,GYNECOLOGIE ET OBSTETRIQUE - CMCO,0,0,0,0,0,0,0
25/06/2013,CCOM,CCOM Chirurgie,0,3,36,39,5,0,0
25/06/2013,CH Altkirch,Upatou,0,3,44,47,3,1,0
25/06/2013,CH de Colmar (CMC Le Parc),SAU Le Parc,5,0,39,44,10,0,1
25/06/2013,CH de Colmar (Louis Pasteur),SAU Pasteur,0,26,103,129,23,13,0
25/06/2013,CH de Guebwiller,UHTCD,0,0,44,44,0,2,0
25/06/2013,CH de Mulhouse ( Hasenrain),PEDIATRIE NEONATOLOGIE,14,0,35,49,3,1,0
25/06/2013,CH de Mulhouse (Emile Muller-Moenschberg,URGENCES,0,21,120,141,9,12,4
25/06/2013,CH de Saverne,S.A.U. (ADULTES),0,8,34,42,6,0,0
25/06/2013,CH de Saverne,PEDIATRIE,4,0,16,20,3,1,0
25/06/2013,CH de Sélestat,Acceuil des urgences,1,15,74,90,13,6,2
25/06/2013,CH de Thann,Urgences,0,5,43,48,2,0,2
25/06/2013,CHU de Strasbourg (Hôp. Civil),Urgences Médico-Chirurgicales NHC,0,13,66,79,41,9,1
25/06/2013,CHU de Strasbourg(Hautepierre),Urgences chirurgicales pédiatriques,11,0,43,54,11,11,0
25/06/2013,CHU de Strasbourg(Hautepierre),Gynéco-Obstétrique (HTP),1,0,25,26,11,0,0
25/06/2013,CHU de Strasbourg(Hautepierre),Urgences Adulte HTP,1,23,81,105,42,0,0
25/06/2013,CHU de Strasbourg(Hautepierre),Urgences chirurgicales pédiatriques,6,0,50,56,1,2,0
25/06/2013,Clinique des 3 Frontières,UPATOU (Structure des urgences),2,6,42,50,6,1,0
25/06/2013,Clinique des Diaconesses,SOS Main,0,1,38,39,10,0,0
25/06/2013,Clinique Ste Odile (Strasbourg,UPATOU,1,4,47,52,5,5,0
25/06/2013,CMCO,GYNECO-OBSTETRIQUE,0,0,0,0,0,0,0
25/06/2013,SIHCUS/CMCO,GYNECOLOGIE ET OBSTETRIQUE - CMCO,0,0,0,0,0,0,0
24/06/2013,CCOM,CCOM Chirurgie,0,1,45,46,2,0,0
24/06/2013,CH Altkirch,Upatou,0,5,50,55,3,2,1
24/06/2013,CH de Colmar (CMC Le Parc),SAU Le Parc,5,0,51,56,8,0,0
24/06/2013,CH de Colmar (Louis Pasteur),SAU Pasteur,0,28,127,155,23,11,0
24/06/2013,CH de Guebwiller,UHTCD,0,4,33,37,1,0,0
24/06/2013,CH de Mulhouse ( Hasenrain),PEDIATRIE NEONATOLOGIE,5,0,29,34,7,1,0
24/06/2013,CH de Mulhouse (Emile Muller-Moenschberg,URGENCES,0,23,131,154,25,11,1
24/06/2013,CH de Saverne,S.A.U. (ADULTES),0,6,48,54,7,1,0
24/06/2013,CH de Saverne,PEDIATRIE,1,0,18,19,0,0,0
24/06/2013,CH de Sélestat,Acceuil des urgences,1,17,85,103,13,4,6
24/06/2013,CH de Thann,Urgences,1,8,43,52,4,1,1
24/06/2013,CHU de Strasbourg (Hôp. Civil),Urgences Médico-Chirurgicales NHC,0,15,81,96,58,9,1
24/06/2013,CHU de Strasbourg(Hautepierre),Gynéco-Obstétrique (HTP),0,0,27,27,13,0,0
24/06/2013,CHU de Strasbourg(Hautepierre),Urgences Adulte HTP,0,19,89,108,39,0,1
24/06/2013,CHU de Strasbourg(Hautepierre),Urgences chirurgicales pédiatriques,4,0,68,72,5,6,0
24/06/2013,CHU de Strasbourg(Hautepierre),Urgences chirurgicales pédiatriques,18,0,48,66,7,7,0
24/06/2013,Clinique des 3 Frontières,UPATOU (Structure des urgences),2,6,49,57,6,0,0
24/06/2013,Clinique des Diaconesses,SOS Main,0,0,54,54,0,0,1
24/06/2013,Clinique Ste Odile (Strasbourg,UPATOU,0,3,75,78,2,7,4
24/06/2013,CMCO,GYNECO-OBSTETRIQUE,0,0,0,0,0,0,0
24/06/2013,SIHCUS/CMCO,GYNECOLOGIE ET OBSTETRIQUE - CMCO,0,0,0,0,0,0,0
23/06/2013,CCOM,CCOM Chirurgie,0,1,22,23,5,0,0
23/06/2013,CH Altkirch,Upatou,0,4,52,56,3,0,0
23/06/2013,CH de Colmar (CMC Le Parc),SAU Le Parc,8,0,61,69,9,0,0
23/06/2013,CH de Colmar (Louis Pasteur),SAU Pasteur,0,18,104,122,21,11,2
23/06/2013,CH de Guebwiller,UHTCD,0,1,64,65,0,2,1
23/06/2013,CH de Mulhouse ( Hasenrain),PEDIATRIE NEONATOLOGIE,8,0,48,56,6,1,0
23/06/2013,CH de Mulhouse (Emile Muller-Moenschberg,URGENCES,0,27,115,142,12,12,1
23/06/2013,CH de Saverne,PEDIATRIE,3,0,18,21,1,0,0
23/06/2013,CH de Saverne,S.A.U. (ADULTES),0,9,55,64,9,4,0
23/06/2013,CH de Thann,Urgences,0,2,58,60,2,5,3
23/06/2013,CH de Wissembourg,Urgences ,1,5,39,45,6,1,0
23/06/2013,CHU de Strasbourg (Hôp. Civil),Urgences Médico-Chirurgicales NHC,0,15,68,83,34,0,0
23/06/2013,CHU de Strasbourg(Hautepierre),Urgences chirurgicales pédiatriques,1,0,62,63,9,8,0
23/06/2013,CHU de Strasbourg(Hautepierre),Urgences chirurgicales pédiatriques,11,0,54,65,5,5,0
23/06/2013,CHU de Strasbourg(Hautepierre),Gynéco-Obstétrique (HTP),1,0,27,28,10,0,0
23/06/2013,CHU de Strasbourg(Hautepierre),Urgences Adulte HTP,0,21,84,105,20,1,0
23/06/2013,Clinique des 3 Frontières,UPATOU (Structure des urgences),2,5,45,52,6,0,2
23/06/2013,Clinique Ste Odile (Strasbourg,UPATOU,0,3,97,100,1,9,4
23/06/2013,CMCO,GYNECO-OBSTETRIQUE,0,0,0,0,0,0,0
23/06/2013,SIHCUS/CMCO,GYNECOLOGIE ET OBSTETRIQUE - CMCO,0,0,0,0,0,0,0
22/06/2013,CCOM,CCOM Chirurgie,0,0,23,23,1,0,0
22/06/2013,CH Altkirch,Upatou,0,8,48,56,3,1,2
22/06/2013,CH de Colmar (CMC Le Parc),SAU Le Parc,5,0,68,73,10,0,0
22/06/2013,CH de Colmar (Louis Pasteur),SAU Pasteur,0,28,127,155,25,11,4
22/06/2013,CH de Guebwiller,UHTCD,0,3,65,68,1,5,7
22/06/2013,CH de Mulhouse ( Hasenrain),PEDIATRIE NEONATOLOGIE,18,0,26,44,3,4,0
22/06/2013,CH de Mulhouse (Emile Muller-Moenschberg,URGENCES,0,24,145,169,11,7,2
22/06/2013,CH de Saverne,S.A.U. (ADULTES),0,10,50,60,9,0,0
22/06/2013,CH de Saverne,PEDIATRIE,3,0,15,18,2,0,0
22/06/2013,CH de Sélestat,Acceuil des urgences,2,8,110,120,18,4,4
22/06/2013,CH de Thann,Urgences,0,4,53,57,2,2,2
22/06/2013,CH de Wissembourg,Urgences ,0,4,37,41,6,1,0
22/06/2013,CHU de Strasbourg (Hôp. Civil),Urgences Médico-Chirurgicales NHC,0,19,88,107,34,2,0
22/06/2013,CHU de Strasbourg(Hautepierre),Urgences chirurgicales pédiatriques,5,0,72,77,10,10,0
22/06/2013,CHU de Strasbourg(Hautepierre),Urgences chirurgicales pédiatriques,15,0,62,77,8,8,0
22/06/2013,CHU de Strasbourg(Hautepierre),Gynéco-Obstétrique (HTP),0,0,36,36,13,0,0
22/06/2013,CHU de Strasbourg(Hautepierre),Urgences Adulte HTP,0,11,105,116,30,0,0
22/06/2013,Clinique des 3 Frontières,UPATOU (Structure des urgences),0,2,57,59,4,1,1
22/06/2013,Clinique Ste Odile (Strasbourg,UPATOU,0,7,88,95,2,6,0
22/06/2013,CMCO,GYNECO-OBSTETRIQUE,0,0,0,0,0,0,0
22/06/2013,SIHCUS/CMCO,GYNECOLOGIE ET OBSTETRIQUE - CMCO,0,0,0,0,0,0,0
21/06/2013,CCOM,CCOM Chirurgie,0,0,24,24,1,0,0
21/06/2013,CH Altkirch,Upatou,0,4,48,52,4,1,3
21/06/2013,CH de Colmar (CMC Le Parc),SAU Le Parc,13,0,52,65,14,0,1
21/06/2013,CH de Colmar (Louis Pasteur),SAU Pasteur,0,43,89,132,32,12,2
21/06/2013,CH de Guebwiller,UHTCD,0,3,50,53,2,0,6
21/06/2013,CH de Mulhouse ( Hasenrain),PEDIATRIE NEONATOLOGIE,8,0,21,29,7,1,0
21/06/2013,CH de Mulhouse (Emile Muller-Moenschberg,URGENCES,0,24,118,142,15,12,1
21/06/2013,CH de Saverne,S.A.U. (ADULTES),0,10,52,62,8,2,0
21/06/2013,CH de Saverne,PEDIATRIE,4,0,11,15,1,0,0
21/06/2013,CH de Sélestat,Acceuil des urgences,2,11,83,96,22,5,2
21/06/2013,CH de Thann,Urgences,0,3,49,52,3,1,0
21/06/2013,CH de Wissembourg,Urgences ,2,5,32,39,13,0,1
21/06/2013,CHU de Strasbourg (Hôp. Civil),Urgences Médico-Chirurgicales NHC,0,19,67,86,47,3,1
21/06/2013,CHU de Strasbourg(Hautepierre),Urgences chirurgicales pédiatriques,9,0,36,45,3,4,0
21/06/2013,CHU de Strasbourg(Hautepierre),Gynéco-Obstétrique (HTP),0,0,27,27,11,0,0
21/06/2013,CHU de Strasbourg(Hautepierre),Urgences chirurgicales pédiatriques,2,0,50,52,6,6,0
21/06/2013,CHU de Strasbourg(Hautepierre),Urgences Adulte HTP,0,12,97,109,33,0,1
21/06/2013,Clinique des 3 Frontières,UPATOU (Structure des urgences),0,5,40,45,4,1,1
21/06/2013,Clinique Ste Odile (Strasbourg,UPATOU,0,6,73,79,1,6,1
21/06/2013,CMCO,GYNECO-OBSTETRIQUE,0,0,0,0,0,0,0
21/06/2013,SIHCUS/CMCO,GYNECOLOGIE ET OBSTETRIQUE - CMCO,0,0,0,0,0,0,0
20/06/2013,CCOM,CCOM Chirurgie,0,1,24,25,2,0,0
20/06/2013,CH Altkirch,Upatou,1,7,33,41,11,3,0
20/06/2013,CH de Colmar (CMC Le Parc),SAU Le Parc,4,0,37,41,5,0,0
20/06/2013,CH de Colmar (Louis Pasteur),SAU Pasteur,0,31,107,138,17,14,4
20/06/2013,CH de Guebwiller,UHTCD,1,2,48,51,1,0,0
20/06/2013,CH de Mulhouse ( Hasenrain),PEDIATRIE NEONATOLOGIE,6,0,32,38,4,2,0
20/06/2013,CH de Mulhouse (Emile Muller-Moenschberg,URGENCES,2,24,120,146,14,10,5
20/06/2013,CH de Saverne,S.A.U. (ADULTES),0,11,55,66,9,4,0
20/06/2013,CH de Saverne,PEDIATRIE,4,0,11,15,0,1,0
20/06/2013,CH de Sélestat,Acceuil des urgences,0,11,82,93,21,7,3
20/06/2013,CH de Thann,Urgences,0,7,46,53,5,3,0
20/06/2013,CH de Wissembourg,Urgences ,0,3,32,35,4,1,0
20/06/2013,CHU de Strasbourg (Hôp. Civil),Urgences Médico-Chirurgicales NHC,1,23,62,86,43,0,4
20/06/2013,CHU de Strasbourg(Hautepierre),Urgences chirurgicales pédiatriques,6,0,57,63,3,3,0
20/06/2013,CHU de Strasbourg(Hautepierre),Urgences chirurgicales pédiatriques,10,0,45,55,5,5,0
20/06/2013,CHU de Strasbourg(Hautepierre),Gynéco-Obstétrique (HTP),0,0,21,21,8,0,0
20/06/2013,CHU de Strasbourg(Hautepierre),Urgences Adulte HTP,0,10,72,82,24,0,1
20/06/2013,Clinique des 3 Frontières,UPATOU (Structure des urgences),0,6,45,51,7,0,0
20/06/2013,Clinique des Diaconesses,SOS Main,0,1,31,32,0,1,1
20/06/2013,Clinique Ste Odile (Strasbourg,UPATOU,0,4,68,72,2,3,0
20/06/2013,CMCO,GYNECO-OBSTETRIQUE,0,0,0,0,0,0,0
20/06/2013,SIHCUS/CMCO,GYNECOLOGIE ET OBSTETRIQUE - CMCO,0,0,0,0,0,0,0
19/06/2013,CCOM,CCOM Chirurgie,0,0,19,19,1,0,0
19/06/2013,CH Altkirch,Upatou,0,7,47,54,5,1,6
19/06/2013,CH de Colmar (CMC Le Parc),SAU Le Parc,11,0,43,54,9,0,0
19/06/2013,CH de Colmar (Louis Pasteur),SAU Pasteur,0,16,113,129,16,10,1
19/06/2013,CH de Guebwiller,UHTCD,0,7,45,52,0,4,4
19/06/2013,CH de Mulhouse ( Hasenrain),PEDIATRIE NEONATOLOGIE,11,0,34,45,8,1,1
19/06/2013,CH de Mulhouse (Emile Muller-Moenschberg,URGENCES,2,15,122,139,14,4,4
19/06/2013,CH de Saverne,PEDIATRIE,3,0,17,20,0,1,0
19/06/2013,CH de Saverne,S.A.U. (ADULTES),0,7,47,54,5,4,0
19/06/2013,CH de Sélestat,Acceuil des urgences,1,8,81,90,17,3,2
19/06/2013,CH de Thann,Urgences,0,6,42,48,5,0,1
19/06/2013,CH de Wissembourg,Urgences ,1,3,28,32,5,0,0
19/06/2013,CHU de Strasbourg (Hôp. Civil),Urgences Médico-Chirurgicales NHC,0,22,63,85,45,0,3
19/06/2013,CHU de Strasbourg(Hautepierre),Urgences chirurgicales pédiatriques,8,0,36,44,4,4,0
19/06/2013,CHU de Strasbourg(Hautepierre),Gynéco-Obstétrique (HTP),0,0,16,16,10,0,0
19/06/2013,CHU de Strasbourg(Hautepierre),Urgences Adulte HTP,0,21,67,88,32,0,0
19/06/2013,CHU de Strasbourg(Hautepierre),Urgences chirurgicales pédiatriques,1,0,47,48,0,0,0
19/06/2013,Clinique des 3 Frontières,UPATOU (Structure des urgences),0,1,39,40,7,0,1
19/06/2013,Clinique des Diaconesses,SOS Main,0,0,38,38,15,0,1
19/06/2013,Clinique Ste Odile (Strasbourg,UPATOU,0,2,74,76,2,6,0
19/06/2013,CMCO,GYNECO-OBSTETRIQUE,0,0,0,0,0,0,0
19/06/2013,SIHCUS/CMCO,GYNECOLOGIE ET OBSTETRIQUE - CMCO,0,0,0,0,0,0,0
18/06/2013,CCOM,CCOM Chirurgie,0,3,21,24,4,0,0
18/06/2013,CH Altkirch,Upatou,0,5,42,47,3,2,3
18/06/2013,CH de Colmar (CMC Le Parc),SAU Le Parc,5,0,36,41,1,0,0
18/06/2013,CH de Colmar (Louis Pasteur),SAU Pasteur,0,17,101,118,27,15,0
18/06/2013,CH de Guebwiller,UHTCD,1,7,47,55,0,3,3
18/06/2013,CH de Mulhouse ( Hasenrain),PEDIATRIE NEONATOLOGIE,10,0,28,38,7,1,0
18/06/2013,CH de Mulhouse (Emile Muller-Moenschberg,URGENCES,0,23,102,125,8,14,3
18/06/2013,CH de Saverne,S.A.U. (ADULTES),0,10,47,57,7,1,0
18/06/2013,CH de Saverne,PEDIATRIE,2,0,15,17,2,0,0
18/06/2013,CH de Sélestat,Acceuil des urgences,2,8,70,80,13,4,0
18/06/2013,CH de Wissembourg,Urgences ,0,7,25,32,5,1,1
18/06/2013,CHU de Strasbourg (Hôp. Civil),Urgences Médico-Chirurgicales NHC,1,18,64,83,44,2,1
18/06/2013,CHU de Strasbourg(Hautepierre),Gynéco-Obstétrique (HTP),2,0,33,35,10,0,0
18/06/2013,CHU de Strasbourg(Hautepierre),Urgences chirurgicales pédiatriques,2,0,47,49,11,11,0
18/06/2013,CHU de Strasbourg(Hautepierre),Urgences Adulte HTP,0,17,64,81,28,0,0
18/06/2013,CHU de Strasbourg(Hautepierre),Urgences chirurgicales pédiatriques,9,0,36,45,6,5,0
18/06/2013,Clinique des 3 Frontières,UPATOU (Structure des urgences),1,4,46,51,4,0,1
18/06/2013,Clinique des Diaconesses,SOS Main,0,4,39,43,22,0,0
18/06/2013,Clinique Ste Odile (Strasbourg,UPATOU,0,4,72,76,1,6,3
18/06/2013,CMCO,GYNECO-OBSTETRIQUE,0,0,0,0,0,0,0
18/06/2013,SIHCUS/CMCO,GYNECOLOGIE ET OBSTETRIQUE - CMCO,0,0,0,0,0,0,0
17/06/2013,CCOM,CCOM Chirurgie,0,1,43,44,0,0,0
17/06/2013,CH Altkirch,Upatou,0,5,41,46,7,0,2
17/06/2013,CH de Colmar (CMC Le Parc),SAU Le Parc,6,0,42,48,5,0,0
17/06/2013,CH de Colmar (Louis Pasteur),SAU Pasteur,0,29,122,151,23,8,0
17/06/2013,CH de Guebwiller,UHTCD,0,7,46,53,1,4,1
17/06/2013,CH de Mulhouse ( Hasenrain),PEDIATRIE NEONATOLOGIE,10,0,30,40,7,2,0
17/06/2013,CH de Mulhouse (Emile Muller-Moenschberg,URGENCES,0,25,120,145,11,8,2
17/06/2013,CH de Saverne,PEDIATRIE,3,0,23,26,2,1,0
17/06/2013,CH de Saverne,S.A.U. (ADULTES),0,12,59,71,11,7,1
17/06/2013,CH de Sélestat,Acceuil des urgences,1,16,100,117,23,7,1
17/06/2013,CH de Thann,Urgences,0,7,53,60,5,1,0
17/06/2013,CH de Wissembourg,Urgences ,0,10,30,40,9,0,0
17/06/2013,CHU de Strasbourg (Hôp. Civil),Urgences Médico-Chirurgicales NHC,0,26,60,86,55,2,0
17/06/2013,CHU de Strasbourg(Hautepierre),Urgences chirurgicales pédiatriques,11,0,41,52,8,8,0
17/06/2013,CHU de Strasbourg(Hautepierre),Gynéco-Obstétrique (HTP),0,1,24,25,13,0,0
17/06/2013,CHU de Strasbourg(Hautepierre),Urgences chirurgicales pédiatriques,3,0,55,58,3,3,0
17/06/2013,CHU de Strasbourg(Hautepierre),Urgences Adulte HTP,0,23,90,113,42,0,2
17/06/2013,Clinique des 3 Frontières,UPATOU (Structure des urgences),0,4,39,43,8,0,0
17/06/2013,Clinique Ste Odile (Strasbourg,UPATOU,0,5,75,80,2,6,3
17/06/2013,CMCO,GYNECO-OBSTETRIQUE,0,0,0,0,0,0,0
17/06/2013,SIHCUS/CMCO,GYNECOLOGIE ET OBSTETRIQUE - CMCO,0,0,0,0,0,0,0
16/06/2013,CCOM,CCOM Chirurgie,0,2,22,24,6,0,0
16/06/2013,CH Altkirch,Upatou,0,8,51,59,8,1,4
16/06/2013,CH de Colmar (CMC Le Parc),SAU Le Parc,7,0,60,67,2,0,0
16/06/2013,CH de Colmar (Louis Pasteur),SAU Pasteur,0,17,129,146,24,18,1
16/06/2013,CH de Guebwiller,UHTCD,0,6,64,70,0,2,0
16/06/2013,CH de Mulhouse ( Hasenrain),PEDIATRIE NEONATOLOGIE,11,0,26,37,6,2,0
16/06/2013,CH de Mulhouse (Emile Muller-Moenschberg,URGENCES,0,18,128,146,14,16,3
16/06/2013,CH de Saverne,S.A.U. (ADULTES),0,8,64,72,14,2,0
16/06/2013,CH de Saverne,PEDIATRIE,5,0,26,31,5,0,0
16/06/2013,CH de Sélestat,Acceuil des urgences,3,7,88,98,12,6,0
16/06/2013,CH de Thann,Urgences,0,5,49,54,3,1,1
16/06/2013,CH de Wissembourg,Urgences ,1,13,35,49,8,0,0
16/06/2013,CHU de Strasbourg (Hôp. Civil),Urgences Médico-Chirurgicales NHC,0,23,88,111,45,3,0
16/06/2013,CHU de Strasbourg(Hautepierre),Urgences chirurgicales pédiatriques,7,0,64,71,5,6,0
16/06/2013,CHU de Strasbourg(Hautepierre),Urgences Adulte HTP,0,14,84,98,20,0,0
16/06/2013,CHU de Strasbourg(Hautepierre),Urgences chirurgicales pédiatriques,19,0,59,78,13,13,0
16/06/2013,CHU de Strasbourg(Hautepierre),Gynéco-Obstétrique (HTP),1,0,23,24,6,0,0
16/06/2013,Clinique des 3 Frontières,UPATOU (Structure des urgences),72,6,66,144,3,0,0
16/06/2013,Clinique Ste Odile (Strasbourg,UPATOU,0,6,80,86,2,7,3
16/06/2013,CMCO,GYNECO-OBSTETRIQUE,0,0,0,0,0,0,0
16/06/2013,SIHCUS/CMCO,GYNECOLOGIE ET OBSTETRIQUE - CMCO,0,0,0,0,0,0,0
15/06/2013,CCOM,CCOM Chirurgie,0,0,28,28,6,0,0
15/06/2013,CH Altkirch,Upatou,0,5,45,50,4,5,3
15/06/2013,CH de Colmar (CMC Le Parc),SAU Le Parc,7,0,50,57,7,0,0
15/06/2013,CH de Colmar (Louis Pasteur),SAU Pasteur,0,21,136,157,18,9,5
15/06/2013,CH de Guebwiller,UHTCD,0,4,50,54,2,2,1
15/06/2013,CH de Mulhouse ( Hasenrain),PEDIATRIE NEONATOLOGIE,11,0,29,40,4,0,1
15/06/2013,CH de Mulhouse (Emile Muller-Moenschberg,URGENCES,0,25,121,146,8,19,4
15/06/2013,CH de Saverne,S.A.U. (ADULTES),0,9,41,50,6,4,1
15/06/2013,CH de Saverne,PEDIATRIE,2,0,19,21,0,0,0
15/06/2013,CH de Sélestat,Acceuil des urgences,4,11,77,92,13,4,2
15/06/2013,CH de Thann,Urgences,1,3,59,63,2,0,5
15/06/2013,CH de Wissembourg,Urgences ,0,4,45,49,8,2,1
15/06/2013,CHU de Strasbourg (Hôp. Civil),Urgences Médico-Chirurgicales NHC,0,20,99,119,49,0,3
15/06/2013,CHU de Strasbourg(Hautepierre),Urgences chirurgicales pédiatriques,9,0,37,46,7,7,0
15/06/2013,CHU de Strasbourg(Hautepierre),Gynéco-Obstétrique (HTP),0,0,24,24,7,0,0
15/06/2013,CHU de Strasbourg(Hautepierre),Urgences Adulte HTP,0,11,80,91,26,0,1
15/06/2013,CHU de Strasbourg(Hautepierre),Urgences chirurgicales pédiatriques,2,0,51,53,4,3,0
15/06/2013,Clinique des 3 Frontières,UPATOU (Structure des urgences),1,8,47,56,5,0,1
15/06/2013,Clinique Ste Odile (Strasbourg,UPATOU,1,3,79,83,4,5,1
15/06/2013,CMCO,GYNECO-OBSTETRIQUE,0,0,0,0,0,0,0
15/06/2013,SIHCUS/CMCO,GYNECOLOGIE ET OBSTETRIQUE - CMCO,0,0,0,0,0,0,0
14/06/2013,CCOM,CCOM Chirurgie,0,2,24,26,1,0,0
14/06/2013,CH Altkirch,Upatou,0,3,37,40,5,0,1
14/06/2013,CH de Colmar (CMC Le Parc),SAU Le Parc,8,0,47,55,10,0,0
14/06/2013,CH de Colmar (Louis Pasteur),SAU Pasteur,0,20,108,128,11,18,2
14/06/2013,CH de Guebwiller,UHTCD,0,4,44,48,3,3,1
14/06/2013,CH de Mulhouse ( Hasenrain),PEDIATRIE NEONATOLOGIE,7,0,28,35,7,0,0
14/06/2013,CH de Mulhouse (Emile Muller-Moenschberg,URGENCES,0,16,126,142,10,10,3
14/06/2013,CH de Saverne,PEDIATRIE,3,0,20,23,2,0,0
14/06/2013,CH de Saverne,S.A.U. (ADULTES),0,17,47,64,9,5,1
14/06/2013,CH de Sélestat,Acceuil des urgences,0,9,70,79,8,5,2
14/06/2013,CH de Thann,Urgences,0,3,40,43,1,0,1
14/06/2013,CH de Wissembourg,Urgences ,0,7,29,36,6,0,2
14/06/2013,CHU de Strasbourg (Hôp. Civil),Urgences Médico-Chirurgicales NHC,0,16,75,91,50,2,1
14/06/2013,CHU de Strasbourg(Hautepierre),Urgences chirurgicales pédiatriques,3,0,57,60,2,2,0
14/06/2013,CHU de Strasbourg(Hautepierre),Urgences chirurgicales pédiatriques,6,0,41,47,5,5,0
14/06/2013,CHU de Strasbourg(Hautepierre),Urgences Adulte HTP,0,18,87,105,42,0,0
14/06/2013,CHU de Strasbourg(Hautepierre),Gynéco-Obstétrique (HTP),0,0,36,36,17,0,0
14/06/2013,Clinique des 3 Frontières,UPATOU (Structure des urgences),1,4,36,41,4,0,1
14/06/2013,Clinique des Diaconesses,SOS Main,0,0,44,44,0,0,0
14/06/2013,Clinique Ste Odile (Strasbourg,UPATOU,0,5,71,76,1,7,1
14/06/2013,CMCO,GYNECO-OBSTETRIQUE,0,0,0,0,0,0,0
14/06/2013,SIHCUS/CMCO,GYNECOLOGIE ET OBSTETRIQUE - CMCO,0,0,44,44,0,0,0
13/06/2013,CCOM,CCOM Chirurgie,0,1,29,30,4,0,0
13/06/2013,CH Altkirch,Upatou,0,6,38,44,4,1,1
13/06/2013,CH de Colmar (CMC Le Parc),SAU Le Parc,6,0,46,52,7,0,0
13/06/2013,CH de Colmar (Louis Pasteur),SAU Pasteur,0,28,100,128,25,11,1
13/06/2013,CH de Guebwiller,UHTCD,1,2,47,50,1,2,3
13/06/2013,CH de Mulhouse ( Hasenrain),PEDIATRIE NEONATOLOGIE,7,0,19,26,4,1,0
13/06/2013,CH de Mulhouse (Emile Muller-Moenschberg,URGENCES,1,29,106,136,18,9,6
13/06/2013,CH de Saverne,PEDIATRIE,2,0,10,12,2,0,0
13/06/2013,CH de Saverne,S.A.U. (ADULTES),0,14,45,59,14,5,1
13/06/2013,CH de Sélestat,Acceuil des urgences,1,8,62,71,13,3,1
13/06/2013,CH de Wissembourg,Urgences ,0,4,25,29,5,0,1
13/06/2013,CHU de Strasbourg (Hôp. Civil),Urgences Médico-Chirurgicales NHC,0,19,59,78,29,4,2
13/06/2013,CHU de Strasbourg(Hautepierre),Urgences Adulte HTP,0,20,83,103,33,0,0
13/06/2013,CHU de Strasbourg(Hautepierre),Urgences chirurgicales pédiatriques,14,0,31,45,6,6,0
13/06/2013,CHU de Strasbourg(Hautepierre),Gynéco-Obstétrique (HTP),0,1,24,25,14,0,0
13/06/2013,CHU de Strasbourg(Hautepierre),Urgences chirurgicales pédiatriques,1,0,65,66,5,5,0
13/06/2013,Clinique des 3 Frontières,UPATOU (Structure des urgences),0,9,47,56,8,0,1
13/06/2013,Clinique Ste Odile (Strasbourg,UPATOU,0,2,69,71,1,8,2
13/06/2013,CMCO,GYNECO-OBSTETRIQUE,0,0,0,0,0,0,0
13/06/2013,SIHCUS/CMCO,GYNECOLOGIE ET OBSTETRIQUE - CMCO,0,0,0,0,0,0,0
12/06/2013,CCOM,CCOM Chirurgie,0,2,28,30,4,0,0
12/06/2013,CH Altkirch,Upatou,0,5,42,47,5,3,2
12/06/2013,CH de Colmar (CMC Le Parc),SAU Le Parc,6,0,38,44,5,0,0
12/06/2013,CH de Colmar (Louis Pasteur),SAU Pasteur,0,16,109,125,16,12,1
12/06/2013,CH de Guebwiller,UHTCD,0,3,44,47,0,1,2
12/06/2013,CH de Mulhouse ( Hasenrain),PEDIATRIE NEONATOLOGIE,11,0,38,49,7,2,1
12/06/2013,CH de Mulhouse (Emile Muller-Moenschberg,URGENCES,3,20,143,166,17,10,5
12/06/2013,CH de Saverne,S.A.U. (ADULTES),0,8,41,49,3,3,1
12/06/2013,CH de Saverne,PEDIATRIE,2,0,25,27,0,0,0
12/06/2013,CH de Sélestat,Acceuil des urgences,2,7,77,86,13,4,4
12/06/2013,CH de Thann,Urgences,1,8,49,58,3,0,4
12/06/2013,CH de Wissembourg,Urgences ,0,8,37,45,5,0,1
12/06/2013,CHU de Strasbourg (Hôp. Civil),Urgences Médico-Chirurgicales NHC,0,24,63,87,52,2,1
12/06/2013,CHU de Strasbourg(Hautepierre),Urgences chirurgicales pédiatriques,4,0,62,66,10,10,0
12/06/2013,CHU de Strasbourg(Hautepierre),Urgences Adulte HTP,0,19,71,90,30,0,0
12/06/2013,CHU de Strasbourg(Hautepierre),Urgences chirurgicales pédiatriques,14,0,34,48,8,7,0
12/06/2013,CHU de Strasbourg(Hautepierre),Gynéco-Obstétrique (HTP),1,0,26,27,10,0,0
12/06/2013,Clinique des 3 Frontières,UPATOU (Structure des urgences),0,4,37,41,8,0,1
12/06/2013,Clinique Ste Odile (Strasbourg,UPATOU,0,2,84,86,0,5,1
12/06/2013,CMCO,GYNECO-OBSTETRIQUE,0,0,0,0,0,0,0
12/06/2013,SIHCUS/CMCO,GYNECOLOGIE ET OBSTETRIQUE - CMCO,0,0,0,0,0,0,0
11/06/2013,CCOM,CCOM Chirurgie,0,1,25,26,3,0,0
11/06/2013,CH Altkirch,Upatou,0,7,49,56,7,4,1
11/06/2013,CH de Colmar (CMC Le Parc),SAU Le Parc,10,0,53,63,10,0,0
11/06/2013,CH de Colmar (Louis Pasteur),SAU Pasteur,0,16,108,124,17,14,0
11/06/2013,CH de Guebwiller,UHTCD,1,9,44,54,2,3,2
11/06/2013,CH de Mulhouse ( Hasenrain),PEDIATRIE NEONATOLOGIE,12,0,23,35,6,2,0
11/06/2013,CH de Mulhouse (Emile Muller-Moenschberg,URGENCES,0,25,125,150,15,18,1
11/06/2013,CH de Saverne,S.A.U. (ADULTES),0,12,54,66,13,5,0
11/06/2013,CH de Saverne,PEDIATRIE,1,0,10,11,3,0,0
11/06/2013,CH de Sélestat,Acceuil des urgences,2,11,63,76,10,3,4
11/06/2013,CH de Thann,Urgences,1,6,44,51,6,2,2
11/06/2013,CH de Wissembourg,Urgences ,0,5,29,34,5,1,0
11/06/2013,CHU de Strasbourg (Hôp. Civil),Urgences Médico-Chirurgicales NHC,0,21,62,83,41,2,0
11/06/2013,CHU de Strasbourg(Hautepierre),Urgences chirurgicales pédiatriques,11,0,36,47,7,7,0
11/06/2013,CHU de Strasbourg(Hautepierre),Gynéco-Obstétrique (HTP),0,1,26,27,16,0,0
11/06/2013,CHU de Strasbourg(Hautepierre),Urgences Adulte HTP,0,16,90,106,38,0,0
11/06/2013,CHU de Strasbourg(Hautepierre),Urgences chirurgicales pédiatriques,4,0,62,66,7,7,0
11/06/2013,Clinique des 3 Frontières,UPATOU (Structure des urgences),0,5,36,41,7,0,0
11/06/2013,Clinique des Diaconesses,SOS Main,0,2,37,39,0,0,1
11/06/2013,CMCO,GYNECO-OBSTETRIQUE,0,0,0,0,0,0,0
11/06/2013,SIHCUS/CMCO,GYNECOLOGIE ET OBSTETRIQUE - CMCO,0,0,0,0,0,0,0
10/06/2013,CCOM,CCOM Chirurgie,0,2,39,41,4,0,0
10/06/2013,CH Altkirch,Upatou,0,7,40,47,3,2,2
10/06/2013,CH de Colmar (CMC Le Parc),SAU Le Parc,7,0,57,64,14,0,0
10/06/2013,CH de Colmar (Louis Pasteur),SAU Pasteur,0,27,134,161,20,13,1
10/06/2013,CH de Guebwiller,UHTCD,2,7,41,50,1,3,1
10/06/2013,CH de Mulhouse ( Hasenrain),PEDIATRIE NEONATOLOGIE,7,0,23,30,10,1,0
10/06/2013,CH de Mulhouse (Emile Muller-Moenschberg,URGENCES,0,20,130,150,5,14,5
10/06/2013,CH de Saverne,S.A.U. (ADULTES),0,6,49,55,7,1,2
10/06/2013,CH de Saverne,PEDIATRIE,0,0,17,17,1,2,0
10/06/2013,CH de Thann,Urgences,0,6,44,50,3,1,1
10/06/2013,CH de Wissembourg,Urgences ,0,8,23,31,8,1,1
10/06/2013,CHU de Strasbourg (Hôp. Civil),Urgences Médico-Chirurgicales NHC,0,16,65,81,39,1,2
10/06/2013,CHU de Strasbourg(Hautepierre),Urgences Adulte HTP,0,17,86,103,38,0,1
10/06/2013,CHU de Strasbourg(Hautepierre),Urgences chirurgicales pédiatriques,8,0,32,40,6,6,0
10/06/2013,CHU de Strasbourg(Hautepierre),Gynéco-Obstétrique (HTP),0,0,27,27,11,0,0
10/06/2013,CHU de Strasbourg(Hautepierre),Urgences chirurgicales pédiatriques,1,0,73,74,2,2,0
10/06/2013,Clinique des 3 Frontières,UPATOU (Structure des urgences),1,7,52,60,4,1,0
10/06/2013,Clinique des Diaconesses,SOS Main,0,2,44,46,1,0,2
10/06/2013,Clinique Ste Odile (Strasbourg,UPATOU,1,2,75,78,0,3,2
10/06/2013,CMCO,GYNECO-OBSTETRIQUE,0,0,0,0,0,0,0
10/06/2013,SIHCUS/CMCO,GYNECOLOGIE ET OBSTETRIQUE - CMCO,0,0,0,0,0,0,0
9/06/2013,CCOM,CCOM Chirurgie,0,0,18,18,3,0,0
9/06/2013,CH Altkirch,Upatou,0,9,49,58,3,1,2
9/06/2013,CH de Colmar (CMC Le Parc),SAU Le Parc,9,0,66,75,4,0,0
9/06/2013,CH de Colmar (Louis Pasteur),SAU Pasteur,0,26,121,147,37,9,1
9/06/2013,CH de Guebwiller,UHTCD,0,3,41,44,1,1,1
9/06/2013,CH de Mulhouse ( Hasenrain),PEDIATRIE NEONATOLOGIE,12,0,45,57,2,0,0
9/06/2013,CH de Mulhouse (Emile Muller-Moenschberg,URGENCES,0,19,125,144,19,11,4
9/06/2013,CH de Saverne,PEDIATRIE,2,0,24,26,4,2,0
9/06/2013,CH de Saverne,S.A.U. (ADULTES),0,9,61,70,7,5,1
9/06/2013,CH de Sélestat,Acceuil des urgences,4,14,101,119,15,3,0
9/06/2013,CH de Thann,Urgences,0,6,48,54,3,0,1
9/06/2013,CH de Wissembourg,Urgences ,1,5,45,51,6,1,0
9/06/2013,CHU de Strasbourg (Hôp. Civil),Urgences Médico-Chirurgicales NHC,0,11,79,90,26,2,1
9/06/2013,CHU de Strasbourg(Hautepierre),Urgences chirurgicales pédiatriques,13,0,68,81,6,6,0
9/06/2013,CHU de Strasbourg(Hautepierre),Gynéco-Obstétrique (HTP),1,0,22,23,7,0,0
9/06/2013,CHU de Strasbourg(Hautepierre),Urgences Adulte HTP,0,19,95,114,35,0,2
9/06/2013,CHU de Strasbourg(Hautepierre),Urgences chirurgicales pédiatriques,3,0,59,62,6,5,0
9/06/2013,Clinique des 3 Frontières,UPATOU (Structure des urgences),1,6,54,61,3,0,0
9/06/2013,Clinique des Diaconesses,SOS Main,0,0,36,36,2,0,0
9/06/2013,Clinique Ste Odile (Strasbourg,UPATOU,1,2,98,101,0,6,2
9/06/2013,CMCO,GYNECO-OBSTETRIQUE,0,0,0,0,0,0,0
9/06/2013,SIHCUS/CMCO,GYNECOLOGIE ET OBSTETRIQUE - CMCO,0,0,0,0,0,0,0
8/06/2013,CCOM,CCOM Chirurgie,0,3,17,20,2,0,0
8/06/2013,CH Altkirch,Upatou,1,10,46,57,5,2,3
8/06/2013,CH de Colmar (CMC Le Parc),SAU Le Parc,6,0,47,53,8,0,0
8/06/2013,CH de Colmar (Louis Pasteur),SAU Pasteur,1,20,144,165,29,12,1
8/06/2013,CH de Guebwiller,UHTCD,0,6,48,54,2,1,0
8/06/2013,CH de Mulhouse ( Hasenrain),PEDIATRIE NEONATOLOGIE,8,0,27,35,13,1,0
8/06/2013,CH de Mulhouse (Emile Muller-Moenschberg,URGENCES,0,23,147,170,6,13,2
8/06/2013,CH de Saverne,S.A.U. (ADULTES),0,17,49,66,15,5,0
8/06/2013,CH de Saverne,PEDIATRIE,3,0,24,27,2,2,0
8/06/2013,CH de Sélestat,Acceuil des urgences,4,13,89,106,18,6,2
8/06/2013,CH de Thann,Urgences,0,12,41,53,4,1,1
8/06/2013,CH de Wissembourg,Urgences ,0,7,35,42,5,1,0
8/06/2013,CHU de Strasbourg (Hôp. Civil),Urgences Médico-Chirurgicales NHC,0,20,90,110,38,2,2
8/06/2013,CHU de Strasbourg(Hautepierre),Urgences chirurgicales pédiatriques,4,0,56,60,6,5,0
8/06/2013,CHU de Strasbourg(Hautepierre),Urgences chirurgicales pédiatriques,21,0,35,56,9,9,0
8/06/2013,CHU de Strasbourg(Hautepierre),Gynéco-Obstétrique (HTP),0,0,16,16,6,0,0
8/06/2013,CHU de Strasbourg(Hautepierre),Urgences Adulte HTP,0,19,104,123,35,0,1
8/06/2013,Clinique des 3 Frontières,UPATOU (Structure des urgences),2,7,53,62,11,1,3
8/06/2013,Clinique des Diaconesses,SOS Main,0,2,34,36,0,0,0
8/06/2013,CMCO,GYNECO-OBSTETRIQUE,0,0,0,0,0,0,0
8/06/2013,SIHCUS/CMCO,GYNECOLOGIE ET OBSTETRIQUE - CMCO,0,0,0,0,0,0,0
7/06/2013,CCOM,CCOM Chirurgie,0,1,21,22,1,0,0
7/06/2013,CH Altkirch,Upatou,0,9,41,50,6,1,4
7/06/2013,CH de Colmar (CMC Le Parc),SAU Le Parc,9,0,47,56,10,2,0
7/06/2013,CH de Colmar (Louis Pasteur),SAU Pasteur,1,16,120,137,21,11,5
7/06/2013,CH de Guebwiller,UHTCD,0,4,49,53,0,4,0
7/06/2013,CH de Mulhouse ( Hasenrain),PEDIATRIE NEONATOLOGIE,15,0,26,41,4,0,0
7/06/2013,CH de Mulhouse (Emile Muller-Moenschberg,URGENCES,0,29,124,153,22,11,3
7/06/2013,CH de Saverne,PEDIATRIE,3,0,13,16,1,0,0
7/06/2013,CH de Saverne,S.A.U. (ADULTES),0,11,44,55,14,6,0
7/06/2013,CH de Sélestat,Acceuil des urgences,2,14,67,83,22,8,0
7/06/2013,CH de Thann,Urgences,1,4,33,38,3,0,1
7/06/2013,CH de Wissembourg,Urgences ,0,10,29,39,9,1,0
7/06/2013,CHU de Strasbourg (Hôp. Civil),Urgences Médico-Chirurgicales NHC,0,24,63,87,44,3,0
7/06/2013,CHU de Strasbourg(Hautepierre),Urgences chirurgicales pédiatriques,2,0,55,57,5,5,0
7/06/2013,CHU de Strasbourg(Hautepierre),Urgences Adulte HTP,0,12,96,108,35,0,1
7/06/2013,CHU de Strasbourg(Hautepierre),Urgences chirurgicales pédiatriques,13,0,30,43,9,9,0
7/06/2013,CHU de Strasbourg(Hautepierre),Gynéco-Obstétrique (HTP),0,0,23,23,8,0,0
7/06/2013,Clinique des 3 Frontières,UPATOU (Structure des urgences),1,4,45,50,10,0,2
7/06/2013,Clinique Ste Odile (Strasbourg,UPATOU,0,4,59,63,1,4,0
7/06/2013,CMCO,GYNECO-OBSTETRIQUE,0,0,0,0,0,0,0
7/06/2013,SIHCUS/CMCO,GYNECOLOGIE ET OBSTETRIQUE - CMCO,0,0,0,0,0,0,0
6/06/2013,CCOM,CCOM Chirurgie,0,1,26,27,0,0,0
6/06/2013,CH Altkirch,Upatou,0,3,43,46,5,0,1
6/06/2013,CH de Colmar (CMC Le Parc),SAU Le Parc,3,0,38,41,12,0,0
6/06/2013,CH de Colmar (Louis Pasteur),SAU Pasteur,0,30,91,121,22,7,0
6/06/2013,CH de Guebwiller,UHTCD,1,3,25,29,2,0,0
6/06/2013,CH de Mulhouse ( Hasenrain),PEDIATRIE NEONATOLOGIE,10,0,29,39,3,0,0
6/06/2013,CH de Mulhouse (Emile Muller-Moenschberg,URGENCES,2,28,115,145,14,12,5
6/06/2013,CH de Saverne,S.A.U. (ADULTES),0,15,53,68,12,2,0
6/06/2013,CH de Saverne,PEDIATRIE,3,0,15,18,6,0,0
6/06/2013,CH de Sélestat,Acceuil des urgences,2,8,73,83,14,4,4
6/06/2013,CH de Thann,Urgences,0,10,27,37,4,1,3
6/06/2013,CH de Wissembourg,Urgences ,1,7,39,47,6,1,1
6/06/2013,CHU de Strasbourg (Hôp. Civil),Urgences Médico-Chirurgicales NHC,0,19,58,77,52,1,6
6/06/2013,CHU de Strasbourg(Hautepierre),Urgences chirurgicales pédiatriques,7,0,60,67,7,7,0
6/06/2013,CHU de Strasbourg(Hautepierre),Urgences chirurgicales pédiatriques,15,0,44,59,9,9,0
6/06/2013,CHU de Strasbourg(Hautepierre),Gynéco-Obstétrique (HTP),0,0,29,29,14,0,0
6/06/2013,CHU de Strasbourg(Hautepierre),Urgences Adulte HTP,0,19,81,100,31,0,1
6/06/2013,Clinique des 3 Frontières,UPATOU (Structure des urgences),1,4,41,46,6,0,0
6/06/2013,Clinique des Diaconesses,SOS Main,0,0,37,37,14,0,0
6/06/2013,CMCO,GYNECO-OBSTETRIQUE,0,0,0,0,0,0,0
6/06/2013,SIHCUS/CMCO,GYNECOLOGIE ET OBSTETRIQUE - CMCO,0,0,0,0,0,0,0
5/06/2013,CCOM,CCOM Chirurgie,0,3,24,27,0,0,0
5/06/2013,CH Altkirch,Upatou,0,4,28,32,3,1,2
5/06/2013,CH de Colmar (CMC Le Parc),SAU Le Parc,3,0,41,44,9,0,0
5/06/2013,CH de Colmar (Louis Pasteur),SAU Pasteur,0,23,105,128,22,9,1
5/06/2013,CH de Guebwiller,UHTCD,1,2,46,49,1,1,1
5/06/2013,CH de Mulhouse ( Hasenrain),PEDIATRIE NEONATOLOGIE,6,0,24,30,8,0,0
5/06/2013,CH de Mulhouse (Emile Muller-Moenschberg,URGENCES,0,15,112,127,9,10,2
5/06/2013,CH de Saverne,S.A.U. (ADULTES),0,9,36,45,11,2,0
5/06/2013,CH de Saverne,PEDIATRIE,2,0,9,11,0,0,0
5/06/2013,CH de Sélestat,Acceuil des urgences,3,14,66,83,12,4,0
5/06/2013,CH de Thann,Urgences,0,6,35,41,5,2,1
5/06/2013,CH de Wissembourg,Urgences ,0,11,55,66,10,1,0
5/06/2013,CHU de Strasbourg (Hôp. Civil),Urgences Médico-Chirurgicales NHC,0,22,64,86,50,4,0
5/06/2013,CHU de Strasbourg(Hautepierre),Urgences chirurgicales pédiatriques,12,0,33,45,4,5,0
5/06/2013,CHU de Strasbourg(Hautepierre),Gynéco-Obstétrique (HTP),1,0,26,27,13,0,0
5/06/2013,CHU de Strasbourg(Hautepierre),Urgences Adulte HTP,0,12,87,99,34,0,0
5/06/2013,CHU de Strasbourg(Hautepierre),Urgences chirurgicales pédiatriques,3,0,57,60,3,3,0
5/06/2013,Clinique des 3 Frontières,UPATOU (Structure des urgences),2,5,39,46,6,0,0
5/06/2013,Clinique des Diaconesses,SOS Main,0,1,35,36,15,0,1
5/06/2013,Clinique Ste Odile (Strasbourg,UPATOU,0,4,62,66,2,0,0
5/06/2013,CMCO,GYNECO-OBSTETRIQUE,0,0,0,0,0,0,0
5/06/2013,SIHCUS/CMCO,GYNECOLOGIE ET OBSTETRIQUE - CMCO,0,0,0,0,0,0,0
4/06/2013,CCOM,CCOM Chirurgie,0,1,23,24,0,0,0
4/06/2013,CH Altkirch,Upatou,0,6,33,39,1,0,2
4/06/2013,CH de Colmar (CMC Le Parc),SAU Le Parc,5,0,40,45,5,0,0
4/06/2013,CH de Colmar (Louis Pasteur),SAU Pasteur,0,21,124,145,19,12,2
4/06/2013,CH de Guebwiller,UHTCD,1,3,43,47,2,0,3
4/06/2013,CH de Mulhouse ( Hasenrain),PEDIATRIE NEONATOLOGIE,10,0,21,31,3,1,0
4/06/2013,CH de Mulhouse (Emile Muller-Moenschberg,URGENCES,1,23,109,133,16,14,2
4/06/2013,CH de Saverne,PEDIATRIE,5,0,9,14,1,0,0
4/06/2013,CH de Saverne,S.A.U. (ADULTES),0,12,56,68,9,8,1
4/06/2013,CH de Sélestat,Acceuil des urgences,2,6,68,76,11,6,3
4/06/2013,CH de Wissembourg,Urgences ,0,15,66,81,16,3,0
4/06/2013,CHU de Strasbourg (Hôp. Civil),Urgences Médico-Chirurgicales NHC,0,25,71,96,45,3,1
4/06/2013,CHU de Strasbourg(Hautepierre),Urgences chirurgicales pédiatriques,10,0,41,51,9,8,0
4/06/2013,CHU de Strasbourg(Hautepierre),Gynéco-Obstétrique (HTP),3,0,19,22,15,0,0
4/06/2013,CHU de Strasbourg(Hautepierre),Urgences Adulte HTP,0,13,89,102,42,0,0
4/06/2013,CHU de Strasbourg(Hautepierre),Urgences chirurgicales pédiatriques,6,0,44,50,6,5,0
4/06/2013,Clinique des 3 Frontières,UPATOU (Structure des urgences),0,3,35,38,1,0,0
4/06/2013,Clinique Ste Odile (Strasbourg,UPATOU,0,3,74,77,3,8,2
4/06/2013,CMCO,GYNECO-OBSTETRIQUE,0,0,0,0,0,0,0
4/06/2013,SIHCUS/CMCO,GYNECOLOGIE ET OBSTETRIQUE - CMCO,0,0,0,0,0,0,0
3/06/2013,CCOM,CCOM Chirurgie,0,1,30,31,2,0,0
3/06/2013,CH Altkirch,Upatou,0,7,30,37,4,2,1
3/06/2013,CH de Colmar (CMC Le Parc),SAU Le Parc,10,0,50,60,5,0,0
3/06/2013,CH de Colmar (Louis Pasteur),SAU Pasteur,0,32,115,147,20,8,0
3/06/2013,CH de Guebwiller,UHTCD,0,4,49,53,4,1,12
3/06/2013,CH de Mulhouse ( Hasenrain),PEDIATRIE NEONATOLOGIE,18,0,20,38,6,0,0
3/06/2013,CH de Mulhouse (Emile Muller-Moenschberg,URGENCES,0,21,126,147,6,12,1
3/06/2013,CH de Saverne,S.A.U. (ADULTES),0,12,50,62,14,1,0
3/06/2013,CH de Saverne,PEDIATRIE,3,0,26,29,2,2,0
3/06/2013,CH de Sélestat,Acceuil des urgences,0,9,80,89,22,6,3
3/06/2013,CH de Wissembourg,Urgences ,1,11,73,85,15,3,1
3/06/2013,CHU de Strasbourg (Hôp. Civil),Urgences Médico-Chirurgicales NHC,0,26,70,96,49,1,3
3/06/2013,CHU de Strasbourg(Hautepierre),Urgences chirurgicales pédiatriques,1,0,53,54,1,1,0
3/06/2013,CHU de Strasbourg(Hautepierre),Urgences Adulte HTP,0,24,85,109,31,0,1
3/06/2013,CHU de Strasbourg(Hautepierre),Urgences chirurgicales pédiatriques,8,0,46,54,10,10,0
3/06/2013,CHU de Strasbourg(Hautepierre),Gynéco-Obstétrique (HTP),0,0,29,29,11,0,0
3/06/2013,Clinique des 3 Frontières,UPATOU (Structure des urgences),0,8,43,51,7,0,0
3/06/2013,CMCO,GYNECO-OBSTETRIQUE,0,0,0,0,0,0,0
3/06/2013,SIHCUS/CMCO,GYNECOLOGIE ET OBSTETRIQUE - CMCO,0,0,0,0,0,0,0
2/06/2013,CCOM,CCOM Chirurgie,0,1,15,16,5,0,0
2/06/2013,CH Altkirch,Upatou,0,4,41,45,2,2,2
2/06/2013,CH de Colmar (CMC Le Parc),SAU Le Parc,13,0,55,68,6,0,0
2/06/2013,CH de Colmar (Louis Pasteur),SAU Pasteur,0,23,89,112,17,14,0
2/06/2013,CH de Guebwiller,UHTCD,0,0,45,45,0,0,0
2/06/2013,CH de Mulhouse ( Hasenrain),PEDIATRIE NEONATOLOGIE,13,0,30,43,8,1,0
2/06/2013,CH de Mulhouse (Emile Muller-Moenschberg,URGENCES,1,23,120,144,16,7,2
2/06/2013,CH de Saverne,S.A.U. (ADULTES),0,4,46,50,4,0,1
2/06/2013,CH de Saverne,PEDIATRIE,4,0,21,25,3,0,0
2/06/2013,CH de Sélestat,Acceuil des urgences,1,7,92,100,16,3,0
2/06/2013,CH de Thann,Urgences,0,5,52,57,3,0,0
2/06/2013,CH de Wissembourg,Urgences ,1,4,37,42,5,1,1
2/06/2013,CHU de Strasbourg (Hôp. Civil),Urgences Médico-Chirurgicales NHC,0,17,65,82,36,0,1
2/06/2013,CHU de Strasbourg(Hautepierre),Urgences chirurgicales pédiatriques,3,0,59,62,7,7,0
2/06/2013,CHU de Strasbourg(Hautepierre),Urgences chirurgicales pédiatriques,13,0,48,61,8,7,0
2/06/2013,CHU de Strasbourg(Hautepierre),Gynéco-Obstétrique (HTP),0,0,22,22,9,0,0
2/06/2013,CHU de Strasbourg(Hautepierre),Urgences Adulte HTP,0,22,79,101,32,0,2
2/06/2013,Clinique des 3 Frontières,UPATOU (Structure des urgences),0,10,38,48,7,0,1
2/06/2013,Clinique Ste Odile (Strasbourg,UPATOU,1,1,81,83,0,5,3
2/06/2013,CMCO,GYNECO-OBSTETRIQUE,0,0,0,0,0,0,0
2/06/2013,SIHCUS/CMCO,GYNECOLOGIE ET OBSTETRIQUE - CMCO,0,0,3,3,0,0,0
1/06/2013,CCOM,CCOM Chirurgie,0,1,30,31,0,0,0
1/06/2013,CH Altkirch,Upatou,0,4,35,39,4,3,0
1/06/2013,CH de Colmar (CMC Le Parc),SAU Le Parc,3,0,44,47,5,0,1
1/06/2013,CH de Colmar (Louis Pasteur),SAU Pasteur,0,19,104,123,26,12,5
1/06/2013,CH de Guebwiller,UHTCD,1,9,44,54,0,4,1
1/06/2013,CH de Mulhouse ( Hasenrain),PEDIATRIE NEONATOLOGIE,5,0,24,29,4,1,1
1/06/2013,CH de Mulhouse (Emile Muller-Moenschberg,URGENCES,1,30,105,136,18,10,4
1/06/2013,CH de Saverne,PEDIATRIE,5,0,10,15,0,0,0
1/06/2013,CH de Saverne,S.A.U. (ADULTES),0,11,37,48,10,4,0
1/06/2013,CH de Sélestat,Acceuil des urgences,0,4,56,60,12,4,0
1/06/2013,CH de Thann,Urgences,1,6,29,36,2,2,1
1/06/2013,CH de Wissembourg,Urgences ,0,6,47,53,7,0,1
1/06/2013,CHU de Strasbourg (Hôp. Civil),Urgences Médico-Chirurgicales NHC,0,14,87,101,34,1,3
1/06/2013,CHU de Strasbourg(Hautepierre),Urgences chirurgicales pédiatriques,6,0,51,57,3,3,0
1/06/2013,CHU de Strasbourg(Hautepierre),Urgences Adulte HTP,0,14,66,80,21,0,1
1/06/2013,CHU de Strasbourg(Hautepierre),Urgences chirurgicales pédiatriques,13,0,31,44,7,7,0
1/06/2013,CHU de Strasbourg(Hautepierre),Gynéco-Obstétrique (HTP),0,0,32,32,10,0,0
1/06/2013,Clinique des 3 Frontières,UPATOU (Structure des urgences),0,3,41,44,5,0,0
1/06/2013,Clinique des Diaconesses,SOS Main,0,0,22,22,1,0,0
1/06/2013,Clinique Ste Odile (Strasbourg,UPATOU,0,0,66,66,0,1,2
1/06/2013,CMCO,GYNECO-OBSTETRIQUE,0,0,0,0,0,0,0
1/06/2013,SIHCUS/CMCO,GYNECOLOGIE ET OBSTETRIQUE - CMCO,0,0,0,0,0,0,0
31/05/2013,CCOM,CCOM Chirurgie,0,0,33,33,3,0,0
31/05/2013,CH Altkirch,Upatou,0,7,30,37,4,1,3
31/05/2013,CH de Colmar (CMC Le Parc),SAU Le Parc,6,0,42,48,6,0,0
31/05/2013,CH de Colmar (Louis Pasteur),SAU Pasteur,0,22,92,114,24,7,8
31/05/2013,CH de Guebwiller,UHTCD,1,3,30,34,1,2,1
31/05/2013,CH de Mulhouse ( Hasenrain),PEDIATRIE NEONATOLOGIE,10,0,27,37,8,2,0
31/05/2013,CH de Mulhouse (Emile Muller-Moenschberg,URGENCES,1,17,102,120,13,9,3
31/05/2013,CH de Saverne,S.A.U. (ADULTES),0,8,34,42,13,4,1
31/05/2013,CH de Saverne,PEDIATRIE,5,0,9,14,4,0,0
31/05/2013,CH de Thann,Urgences,0,8,35,43,2,0,1
31/05/2013,CH de Wissembourg,Urgences ,0,6,34,40,9,0,0
31/05/2013,CHU de Strasbourg (Hôp. Civil),Urgences Médico-Chirurgicales NHC,0,12,58,70,43,1,3
31/05/2013,CHU de Strasbourg(Hautepierre),Urgences chirurgicales pédiatriques,10,0,31,41,9,9,0
31/05/2013,CHU de Strasbourg(Hautepierre),Gynéco-Obstétrique (HTP),0,0,28,28,13,0,0
31/05/2013,CHU de Strasbourg(Hautepierre),Urgences Adulte HTP,0,17,74,91,30,0,0
31/05/2013,CHU de Strasbourg(Hautepierre),Urgences chirurgicales pédiatriques,2,0,46,48,3,3,0
31/05/2013,Clinique des 3 Frontières,UPATOU (Structure des urgences),0,2,28,30,3,0,0
31/05/2013,Clinique des Diaconesses,SOS Main,0,1,28,29,0,0,0
31/05/2013,Clinique Ste Odile (Strasbourg,UPATOU,0,5,62,67,2,6,1
31/05/2013,CMCO,GYNECO-OBSTETRIQUE,0,0,0,0,0,0,0
31/05/2013,SIHCUS/CMCO,GYNECOLOGIE ET OBSTETRIQUE - CMCO,0,0,0,0,0,0,0
30/05/2013,CCOM,CCOM Chirurgie,0,2,25,27,1,0,0
30/05/2013,CH Altkirch,Upatou,0,7,42,49,7,0,3
30/05/2013,CH de Colmar (CMC Le Parc),SAU Le Parc,5,0,48,53,7,0,0
30/05/2013,CH de Colmar (Louis Pasteur),SAU Pasteur,0,25,109,134,19,12,0
30/05/2013,CH de Guebwiller,UHTCD,0,4,26,30,0,1,2
30/05/2013,CH de Mulhouse ( Hasenrain),PEDIATRIE NEONATOLOGIE,15,0,22,37,3,1,0
30/05/2013,CH de Mulhouse (Emile Muller-Moenschberg,URGENCES,1,28,106,135,12,11,1
30/05/2013,CH de Saverne,PEDIATRIE,7,0,16,23,3,0,0
30/05/2013,CH de Saverne,S.A.U. (ADULTES),1,11,45,57,9,4,0
30/05/2013,CH de Sélestat,Acceuil des urgences,4,5,72,81,9,8,0
30/05/2013,CH de Thann,Urgences,0,3,29,32,1,0,0
30/05/2013,CH de Wissembourg,Urgences ,0,7,19,26,5,0,1
30/05/2013,CHU de Strasbourg (Hôp. Civil),Urgences Médico-Chirurgicales NHC,0,24,50,74,45,4,2
30/05/2013,CHU de Strasbourg(Hautepierre),Urgences chirurgicales pédiatriques,17,0,35,52,5,4,0
30/05/2013,CHU de Strasbourg(Hautepierre),Gynéco-Obstétrique (HTP),0,0,31,31,13,0,0
30/05/2013,CHU de Strasbourg(Hautepierre),Urgences Adulte HTP,0,23,89,112,41,0,0
30/05/2013,CHU de Strasbourg(Hautepierre),Urgences chirurgicales pédiatriques,0,0,39,39,3,3,0
30/05/2013,Clinique des 3 Frontières,UPATOU (Structure des urgences),0,2,50,52,3,0,0
30/05/2013,Clinique des Diaconesses,SOS Main,0,3,33,36,11,0,0
30/05/2013,Clinique Ste Odile (Strasbourg,UPATOU,0,2,61,63,2,10,1
30/05/2013,CMCO,GYNECO-OBSTETRIQUE,0,0,0,0,0,0,0
30/05/2013,SIHCUS/CMCO,GYNECOLOGIE ET OBSTETRIQUE - CMCO,0,0,0,0,0,0,0
29/05/2013,CCOM,CCOM Chirurgie,0,1,28,29,4,0,0
29/05/2013,CH Altkirch,Upatou,0,6,21,27,2,1,2
29/05/2013,CH de Colmar (CMC Le Parc),SAU Le Parc,6,0,37,43,4,0,0
29/05/2013,CH de Colmar (Louis Pasteur),SAU Pasteur,0,15,96,111,11,9,0
29/05/2013,CH de Guebwiller,UHTCD,0,4,31,35,3,1,2
29/05/2013,CH de Mulhouse ( Hasenrain),PEDIATRIE NEONATOLOGIE,8,0,20,28,2,3,0
29/05/2013,CH de Mulhouse (Emile Muller-Moenschberg,URGENCES,0,18,107,125,5,14,4
29/05/2013,CH de Saverne,S.A.U. (ADULTES),1,15,37,53,8,5,0
29/05/2013,CH de Saverne,PEDIATRIE,3,0,14,17,2,0,0
29/05/2013,CH de Thann,Urgences,0,5,48,53,2,0,2
29/05/2013,CHU de Strasbourg (Hôp. Civil),Urgences Médico-Chirurgicales NHC,0,26,54,80,45,3,2
29/05/2013,CHU de Strasbourg(Hautepierre),Urgences Adulte HTP,0,16,75,91,37,0,1
29/05/2013,CHU de Strasbourg(Hautepierre),Urgences chirurgicales pédiatriques,12,0,39,51,10,10,0
29/05/2013,CHU de Strasbourg(Hautepierre),Gynéco-Obstétrique (HTP),0,1,25,26,12,0,0
29/05/2013,CHU de Strasbourg(Hautepierre),Urgences chirurgicales pédiatriques,2,0,42,44,2,2,0
29/05/2013,Clinique des 3 Frontières,UPATOU (Structure des urgences),0,7,37,44,7,1,0
29/05/2013,Clinique des Diaconesses,SOS Main,0,0,44,44,11,0,0
29/05/2013,Clinique Ste Odile (Strasbourg,UPATOU,2,3,61,66,4,11,2
29/05/2013,CMCO,GYNECO-OBSTETRIQUE,0,0,0,0,0,0,0
29/05/2013,SIHCUS/CMCO,GYNECOLOGIE ET OBSTETRIQUE - CMCO,0,0,0,0,0,0,0
28/05/2013,CCOM,CCOM Chirurgie,0,0,35,35,4,0,0
28/05/2013,CH Altkirch,Upatou,1,6,30,37,5,2,2
28/05/2013,CH de Colmar (CMC Le Parc),SAU Le Parc,7,0,53,60,10,0,0
28/05/2013,CH de Colmar (Louis Pasteur),SAU Pasteur,1,21,89,111,28,13,0
28/05/2013,CH de Guebwiller,UHTCD,0,3,44,47,1,5,6
28/05/2013,CH de Mulhouse ( Hasenrain),PEDIATRIE NEONATOLOGIE,9,0,19,28,5,1,0
28/05/2013,CH de Mulhouse (Emile Muller-Moenschberg,URGENCES,1,20,114,135,12,11,4
28/05/2013,CH de Saverne,PEDIATRIE,4,0,11,15,1,0,0
28/05/2013,CH de Saverne,S.A.U. (ADULTES),0,15,35,50,10,4,0
28/05/2013,CH de Thann,Urgences,2,4,34,40,2,0,2
28/05/2013,CH de Wissembourg,Urgences ,0,7,36,43,11,0,2
28/05/2013,CHU de Strasbourg (Hôp. Civil),Urgences Médico-Chirurgicales NHC,0,12,57,69,43,0,3
28/05/2013,CHU de Strasbourg(Hautepierre),Urgences Adulte HTP,0,21,79,100,38,0,0
28/05/2013,CHU de Strasbourg(Hautepierre),Urgences chirurgicales pédiatriques,2,0,76,78,4,4,0
28/05/2013,CHU de Strasbourg(Hautepierre),Urgences chirurgicales pédiatriques,13,0,39,52,9,9,0
28/05/2013,CHU de Strasbourg(Hautepierre),Gynéco-Obstétrique (HTP),1,0,25,26,14,0,0
28/05/2013,Clinique des 3 Frontières,UPATOU (Structure des urgences),0,6,35,41,6,0,0
28/05/2013,Clinique des Diaconesses,SOS Main,0,3,31,34,0,0,1
28/05/2013,Clinique Ste Odile (Strasbourg,UPATOU,1,3,61,65,0,5,2
28/05/2013,CMCO,GYNECO-OBSTETRIQUE,0,0,0,0,0,0,0
28/05/2013,SIHCUS/CMCO,GYNECOLOGIE ET OBSTETRIQUE - CMCO,0,0,0,0,0,0,0
27/05/2013,CCOM,CCOM Chirurgie,0,4,27,31,3,0,0
27/05/2013,CH Altkirch,Upatou,0,8,40,48,5,1,3
27/05/2013,CH de Colmar (CMC Le Parc),SAU Le Parc,7,0,38,45,6,0,0
27/05/2013,CH de Colmar (Louis Pasteur),SAU Pasteur,0,21,124,145,21,14,2
27/05/2013,CH de Guebwiller,UHTCD,0,2,46,48,3,1,0
27/05/2013,CH de Mulhouse ( Hasenrain),PEDIATRIE NEONATOLOGIE,12,0,28,40,8,2,1
27/05/2013,CH de Mulhouse (Emile Muller-Moenschberg,URGENCES,1,24,127,152,16,8,4
27/05/2013,CH de Saverne,S.A.U. (ADULTES),0,16,49,65,14,6,0
27/05/2013,CH de Saverne,PEDIATRIE,1,0,17,18,4,0,0
27/05/2013,CH de Sélestat,Acceuil des urgences,2,8,74,84,8,5,1
27/05/2013,CH de Thann,Urgences,0,6,43,49,5,0,2
27/05/2013,CH de Wissembourg,Urgences ,0,7,43,50,7,1,1
27/05/2013,CHU de Strasbourg (Hôp. Civil),Urgences Médico-Chirurgicales NHC,0,16,61,77,43,1,1
27/05/2013,CHU de Strasbourg(Hautepierre),Urgences chirurgicales pédiatriques,1,0,64,65,7,9,0
27/05/2013,CHU de Strasbourg(Hautepierre),Urgences Adulte HTP,0,21,73,94,36,0,0
27/05/2013,CHU de Strasbourg(Hautepierre),Urgences chirurgicales pédiatriques,8,0,24,32,4,4,0
27/05/2013,CHU de Strasbourg(Hautepierre),Gynéco-Obstétrique (HTP),0,0,23,23,16,0,0
27/05/2013,Clinique des 3 Frontières,UPATOU (Structure des urgences),0,1,49,50,5,0,0
27/05/2013,Clinique des Diaconesses,SOS Main,0,0,39,39,1,0,0
27/05/2013,CMCO,GYNECO-OBSTETRIQUE,0,0,0,0,0,0,0
27/05/2013,SIHCUS/CMCO,GYNECOLOGIE ET OBSTETRIQUE - CMCO,0,0,0,0,0,0,0
26/05/2013,CCOM,CCOM Chirurgie,0,0,13,13,2,0,0
26/05/2013,CH Altkirch,Upatou,1,4,38,43,6,1,3
26/05/2013,CH de Colmar (CMC Le Parc),SAU Le Parc,9,0,37,46,9,0,0
26/05/2013,CH de Colmar (Louis Pasteur),SAU Pasteur,0,18,98,116,15,8,0
26/05/2013,CH de Guebwiller,UHTCD,0,5,39,44,4,1,1
26/05/2013,CH de Mulhouse ( Hasenrain),PEDIATRIE NEONATOLOGIE,12,0,30,42,3,0,0
26/05/2013,CH de Mulhouse (Emile Muller-Moenschberg,URGENCES,0,32,110,142,14,12,5
26/05/2013,CH de Saverne,PEDIATRIE,0,0,20,20,2,1,1
26/05/2013,CH de Saverne,S.A.U. (ADULTES),0,9,40,49,5,4,1
26/05/2013,CH de Sélestat,Acceuil des urgences,2,7,62,71,12,4,0
26/05/2013,CH de Wissembourg,Urgences ,1,6,23,30,4,0,1
26/05/2013,CHU de Strasbourg (Hôp. Civil),Urgences Médico-Chirurgicales NHC,0,13,62,75,36,3,0
26/05/2013,CHU de Strasbourg(Hautepierre),Urgences chirurgicales pédiatriques,3,0,43,46,2,3,0
26/05/2013,CHU de Strasbourg(Hautepierre),Urgences chirurgicales pédiatriques,13,0,37,50,9,9,0
26/05/2013,CHU de Strasbourg(Hautepierre),Gynéco-Obstétrique (HTP),0,0,28,28,7,0,0
26/05/2013,CHU de Strasbourg(Hautepierre),Urgences Adulte HTP,0,21,65,86,33,0,0
26/05/2013,Clinique des Diaconesses,SOS Main,0,0,23,23,0,0,0
26/05/2013,Clinique Ste Odile (Strasbourg,UPATOU,0,4,69,73,1,7,0
26/05/2013,CMCO,GYNECO-OBSTETRIQUE,0,0,0,0,0,0,0
26/05/2013,SIHCUS/CMCO,GYNECOLOGIE ET OBSTETRIQUE - CMCO,0,0,0,0,0,0,0
25/05/2013,CCOM,CCOM Chirurgie,0,1,13,14,0,0,0
25/05/2013,CH Altkirch,Upatou,0,7,33,40,4,1,4
25/05/2013,CH de Colmar (CMC Le Parc),SAU Le Parc,10,0,37,47,8,0,0
25/05/2013,CH de Colmar (Louis Pasteur),SAU Pasteur,0,21,108,129,27,8,4
25/05/2013,CH de Guebwiller,UHTCD,0,2,45,47,1,1,1
25/05/2013,CH de Mulhouse ( Hasenrain),PEDIATRIE NEONATOLOGIE,9,0,23,32,6,2,0
25/05/2013,CH de Mulhouse (Emile Muller-Moenschberg,URGENCES,0,25,124,149,16,7,3
25/05/2013,CH de Saverne,PEDIATRIE,3,0,14,17,0,3,0
25/05/2013,CH de Saverne,S.A.U. (ADULTES),0,13,43,56,8,4,1
25/05/2013,CH de Sélestat,Acceuil des urgences,2,9,76,87,9,3,2
25/05/2013,CH de Thann,Urgences,0,6,34,40,2,1,1
25/05/2013,CH de Wissembourg,Urgences ,1,6,23,30,2,1,0
25/05/2013,CHU de Strasbourg (Hôp. Civil),Urgences Médico-Chirurgicales NHC,0,24,80,104,45,5,0
25/05/2013,CHU de Strasbourg(Hautepierre),Urgences Adulte HTP,0,18,80,98,29,0,0
25/05/2013,CHU de Strasbourg(Hautepierre),Urgences chirurgicales pédiatriques,11,0,31,42,5,5,0
25/05/2013,CHU de Strasbourg(Hautepierre),Gynéco-Obstétrique (HTP),0,0,29,29,10,0,0
25/05/2013,CHU de Strasbourg(Hautepierre),Urgences chirurgicales pédiatriques,0,0,57,57,10,10,0
25/05/2013,Clinique des 3 Frontières,UPATOU (Structure des urgences),2,6,42,50,7,0,0
25/05/2013,Clinique des Diaconesses,SOS Main,0,2,29,31,0,0,1
25/05/2013,Clinique Ste Odile (Strasbourg,UPATOU,0,2,77,79,0,6,1
25/05/2013,CMCO,GYNECO-OBSTETRIQUE,0,0,0,0,0,0,0
25/05/2013,SIHCUS/CMCO,GYNECOLOGIE ET OBSTETRIQUE - CMCO,0,0,0,0,0,0,0
24/05/2013,CCOM,CCOM Chirurgie,0,2,19,21,4,0,0
24/05/2013,CH Altkirch,Upatou,1,4,24,29,6,1,0
24/05/2013,CH de Colmar (CMC Le Parc),SAU Le Parc,4,0,45,49,12,0,0
24/05/2013,CH de Colmar (Louis Pasteur),SAU Pasteur,0,22,106,128,30,10,2
24/05/2013,CH de Guebwiller,UHTCD,0,2,34,36,2,1,1
24/05/2013,CH de Mulhouse ( Hasenrain),PEDIATRIE NEONATOLOGIE,14,0,25,39,6,2,0
24/05/2013,CH de Mulhouse (Emile Muller-Moenschberg,URGENCES,0,24,117,141,22,9,3
24/05/2013,CH de Saverne,PEDIATRIE,5,0,13,18,5,0,0
24/05/2013,CH de Saverne,S.A.U. (ADULTES),0,7,34,41,7,5,0
24/05/2013,CH de Sélestat,Acceuil des urgences,0,11,63,74,13,7,1
24/05/2013,CH de Thann,Urgences,0,6,31,37,3,2,1
24/05/2013,CH de Wissembourg,Urgences ,1,9,33,43,9,1,0
24/05/2013,CHU de Strasbourg (Hôp. Civil),Urgences Médico-Chirurgicales NHC,0,18,55,73,35,2,0
24/05/2013,CHU de Strasbourg(Hautepierre),Urgences chirurgicales pédiatriques,12,0,27,39,5,5,0
24/05/2013,CHU de Strasbourg(Hautepierre),Gynéco-Obstétrique (HTP),0,1,33,34,18,0,0
24/05/2013,CHU de Strasbourg(Hautepierre),Urgences Adulte HTP,0,19,68,87,38,0,0
24/05/2013,CHU de Strasbourg(Hautepierre),Urgences chirurgicales pédiatriques,3,0,41,44,2,2,0
24/05/2013,Clinique des 3 Frontières,UPATOU (Structure des urgences),1,4,37,42,2,0,0
24/05/2013,Clinique des Diaconesses,SOS Main,0,1,37,38,0,0,0
24/05/2013,Clinique Ste Odile (Strasbourg,UPATOU,0,6,62,68,2,9,0
24/05/2013,CMCO,GYNECO-OBSTETRIQUE,0,0,0,0,0,0,0
24/05/2013,SIHCUS/CMCO,GYNECOLOGIE ET OBSTETRIQUE - CMCO,0,0,0,0,0,0,0
23/05/2013,CCOM,CCOM Chirurgie,0,1,16,17,1,0,0
23/05/2013,CH Altkirch,Upatou,0,7,34,41,7,3,0
23/05/2013,CH de Colmar (CMC Le Parc),SAU Le Parc,5,0,46,51,9,0,0
23/05/2013,CH de Colmar (Louis Pasteur),SAU Pasteur,0,22,106,128,17,7,0
23/05/2013,CH de Guebwiller,UHTCD,0,4,33,37,2,4,2
23/05/2013,CH de Mulhouse ( Hasenrain),PEDIATRIE NEONATOLOGIE,11,0,25,36,8,1,0
23/05/2013,CH de Mulhouse (Emile Muller-Moenschberg,URGENCES,0,14,83,97,7,10,4
23/05/2013,CH de Saverne,S.A.U. (ADULTES),0,12,49,61,8,6,1
23/05/2013,CH de Saverne,PEDIATRIE,3,0,16,19,3,2,0
23/05/2013,CH de Sélestat,Acceuil des urgences,1,11,63,75,11,2,4
23/05/2013,CH de Thann,Urgences,0,5,29,34,3,2,2
23/05/2013,CH de Wissembourg,Urgences ,0,9,25,34,0,0,0
23/05/2013,CHU de Strasbourg (Hôp. Civil),Urgences Médico-Chirurgicales NHC,0,18,64,82,45,2,1
23/05/2013,CHU de Strasbourg(Hautepierre),Urgences chirurgicales pédiatriques,13,0,24,37,11,11,0
23/05/2013,CHU de Strasbourg(Hautepierre),Gynéco-Obstétrique (HTP),1,0,24,25,7,0,0
23/05/2013,CHU de Strasbourg(Hautepierre),Urgences Adulte HTP,0,19,81,100,50,0,1
23/05/2013,CHU de Strasbourg(Hautepierre),Urgences chirurgicales pédiatriques,3,0,53,56,3,3,0
23/05/2013,Clinique des 3 Frontières,UPATOU (Structure des urgences),1,0,35,36,2,0,0
23/05/2013,Clinique des Diaconesses,SOS Main,0,0,31,31,0,0,0
23/05/2013,Clinique Ste Odile (Strasbourg,UPATOU,0,3,63,66,1,5,2
23/05/2013,CMCO,GYNECO-OBSTETRIQUE,0,0,0,0,0,0,0
23/05/2013,SIHCUS/CMCO,GYNECOLOGIE ET OBSTETRIQUE - CMCO,0,0,0,0,0,0,0
22/05/2013,CCOM,CCOM Chirurgie,0,1,19,20,1,0,1
22/05/2013,CH Altkirch,Upatou,0,4,27,31,4,0,2
22/05/2013,CH de Colmar (CMC Le Parc),SAU Le Parc,3,0,33,36,8,0,0
22/05/2013,CH de Colmar (Louis Pasteur),SAU Pasteur,1,25,92,118,23,15,1
22/05/2013,CH de Guebwiller,UHTCD,0,6,41,47,2,1,0
22/05/2013,CH de Mulhouse ( Hasenrain),PEDIATRIE NEONATOLOGIE,14,0,22,36,6,0,0
22/05/2013,CH de Mulhouse (Emile Muller-Moenschberg,URGENCES,0,22,96,118,12,13,2
22/05/2013,CH de Saverne,S.A.U. (ADULTES),0,13,35,48,7,8,0
22/05/2013,CH de Saverne,PEDIATRIE,5,0,17,22,3,0,0
22/05/2013,CH de Sélestat,Acceuil des urgences,0,16,62,78,12,5,4
22/05/2013,CH de Thann,Urgences,0,7,37,44,6,0,1
22/05/2013,CH de Wissembourg,Urgences ,0,8,33,41,10,1,0
22/05/2013,CHU de Strasbourg (Hôp. Civil),Urgences Médico-Chirurgicales NHC,0,23,55,78,50,0,2
22/05/2013,CHU de Strasbourg(Hautepierre),Urgences chirurgicales pédiatriques,2,0,41,43,2,2,0
22/05/2013,CHU de Strasbourg(Hautepierre),Urgences Adulte HTP,0,25,70,95,40,0,0
22/05/2013,CHU de Strasbourg(Hautepierre),Urgences chirurgicales pédiatriques,8,0,28,36,4,4,0
22/05/2013,CHU de Strasbourg(Hautepierre),Gynéco-Obstétrique (HTP),2,0,27,29,12,0,0
22/05/2013,Clinique des 3 Frontières,UPATOU (Structure des urgences),0,3,37,40,6,1,1
22/05/2013,Clinique des Diaconesses,SOS Main,0,1,36,37,2,0,0
22/05/2013,Clinique Ste Odile (Strasbourg,UPATOU,0,2,48,50,0,6,1
22/05/2013,CMCO,GYNECO-OBSTETRIQUE,0,0,0,0,0,0,0
22/05/2013,SIHCUS/CMCO,GYNECOLOGIE ET OBSTETRIQUE - CMCO,0,0,0,0,0,0,0
21/05/2013,CCOM,CCOM Chirurgie,0,1,28,29,3,0,0
21/05/2013,CH Altkirch,Upatou,0,5,49,54,4,1,2
21/05/2013,CH de Colmar (CMC Le Parc),SAU Le Parc,7,0,47,54,8,0,0
21/05/2013,CH de Colmar (Louis Pasteur),SAU Pasteur,0,30,102,132,21,5,0
21/05/2013,CH de Guebwiller,UHTCD,0,6,39,45,2,2,0
21/05/2013,CH de Mulhouse ( Hasenrain),PEDIATRIE NEONATOLOGIE,7,0,17,24,4,0,0
21/05/2013,CH de Mulhouse (Emile Muller-Moenschberg,URGENCES,1,21,105,127,15,13,3
21/05/2013,CH de Saverne,PEDIATRIE,3,0,20,23,3,0,0
21/05/2013,CH de Saverne,S.A.U. (ADULTES),0,10,45,55,9,8,1
21/05/2013,CH de Sélestat,Acceuil des urgences,0,11,79,90,15,8,1
21/05/2013,CH de Thann,Urgences,0,8,39,47,3,2,1
21/05/2013,CH de Wissembourg,Urgences ,0,3,34,37,7,0,0
21/05/2013,CHU de Strasbourg (Hôp. Civil),Urgences Médico-Chirurgicales NHC,0,18,74,92,44,2,3
21/05/2013,CHU de Strasbourg(Hautepierre),Urgences chirurgicales pédiatriques,12,0,30,42,6,6,0
21/05/2013,CHU de Strasbourg(Hautepierre),Urgences Adulte HTP,0,19,95,114,43,0,1
21/05/2013,CHU de Strasbourg(Hautepierre),Gynéco-Obstétrique (HTP),0,0,35,35,12,0,0
21/05/2013,CHU de Strasbourg(Hautepierre),Urgences chirurgicales pédiatriques,1,0,60,61,7,7,0
21/05/2013,Clinique des 3 Frontières,UPATOU (Structure des urgences),0,9,30,39,9,0,0
21/05/2013,Clinique des Diaconesses,SOS Main,0,3,38,41,1,0,1
21/05/2013,Clinique Ste Odile (Strasbourg,UPATOU,0,5,69,74,1,7,1
21/05/2013,CMCO,GYNECO-OBSTETRIQUE,0,0,0,0,0,0,0
21/05/2013,SIHCUS/CMCO,GYNECOLOGIE ET OBSTETRIQUE - CMCO,0,0,0,0,0,0,0
20/05/2013,CCOM,CCOM Chirurgie,0,1,20,21,3,0,0
20/05/2013,CH Altkirch,Upatou,0,5,48,53,2,1,2
20/05/2013,CH de Colmar (CMC Le Parc),SAU Le Parc,8,0,37,45,5,0,0
20/05/2013,CH de Colmar (Louis Pasteur),SAU Pasteur,0,15,113,128,19,7,0
20/05/2013,CH de Guebwiller,UHTCD,0,2,43,45,0,1,1
20/05/2013,CH de Mulhouse ( Hasenrain),PEDIATRIE NEONATOLOGIE,13,0,27,40,7,1,0
20/05/2013,CH de Mulhouse (Emile Muller-Moenschberg,URGENCES,1,23,124,148,14,9,0
20/05/2013,CH de Saverne,PEDIATRIE,4,0,14,18,1,0,0
20/05/2013,CH de Saverne,S.A.U. (ADULTES),0,5,42,47,5,4,1
20/05/2013,CH de Sélestat,Acceuil des urgences,1,11,80,92,15,3,4
20/05/2013,CH de Thann,Urgences,0,6,40,46,0,0,1
20/05/2013,CH de Wissembourg,Urgences ,1,3,33,37,5,0,1
20/05/2013,CHU de Strasbourg (Hôp. Civil),Urgences Médico-Chirurgicales NHC,1,14,90,105,41,3,0
20/05/2013,CHU de Strasbourg(Hautepierre),Urgences chirurgicales pédiatriques,3,0,39,42,1,1,0
20/05/2013,CHU de Strasbourg(Hautepierre),Urgences chirurgicales pédiatriques,18,0,45,63,6,6,0
20/05/2013,CHU de Strasbourg(Hautepierre),Urgences Adulte HTP,0,16,84,100,31,0,0
20/05/2013,CHU de Strasbourg(Hautepierre),Gynéco-Obstétrique (HTP),0,0,36,36,13,0,0
20/05/2013,Clinique des 3 Frontières,UPATOU (Structure des urgences),2,4,41,47,3,0,1
20/05/2013,Clinique des Diaconesses,SOS Main,0,1,20,21,0,0,0
20/05/2013,Clinique Ste Odile (Strasbourg,UPATOU,0,5,67,72,0,4,0
20/05/2013,CMCO,GYNECO-OBSTETRIQUE,0,0,0,0,0,0,0
20/05/2013,SIHCUS/CMCO,GYNECOLOGIE ET OBSTETRIQUE - CMCO,0,0,0,0,0,0,0
19/05/2013,CCOM,CCOM Chirurgie,0,1,25,26,7,0,0
19/05/2013,CH Altkirch,Upatou,0,3,39,42,3,0,4
19/05/2013,CH de Colmar (CMC Le Parc),SAU Le Parc,13,0,53,66,7,0,0
19/05/2013,CH de Colmar (Louis Pasteur),SAU Pasteur,0,18,137,155,19,9,3
19/05/2013,CH de Guebwiller,UHTCD,1,5,54,60,1,2,2
19/05/2013,CH de Mulhouse ( Hasenrain),PEDIATRIE NEONATOLOGIE,15,0,23,38,1,1,0
19/05/2013,CH de Mulhouse (Emile Muller-Moenschberg,URGENCES,2,12,129,143,15,10,3
19/05/2013,CH de Saverne,S.A.U. (ADULTES),0,9,45,54,6,5,0
19/05/2013,CH de Saverne,PEDIATRIE,2,0,23,25,3,1,0
19/05/2013,CH de Sélestat,Acceuil des urgences,1,9,112,122,25,9,3
19/05/2013,CH de Thann,Urgences,0,10,50,60,7,3,4
19/05/2013,CH de Wissembourg,Urgences ,2,3,28,33,4,1,1
19/05/2013,CHU de Strasbourg (Hôp. Civil),Urgences Médico-Chirurgicales NHC,0,10,82,92,25,1,2
19/05/2013,CHU de Strasbourg(Hautepierre),Urgences chirurgicales pédiatriques,3,0,54,57,3,3,0
19/05/2013,CHU de Strasbourg(Hautepierre),Urgences Adulte HTP,0,11,105,116,38,0,0
19/05/2013,CHU de Strasbourg(Hautepierre),Urgences chirurgicales pédiatriques,16,0,57,73,12,11,0
19/05/2013,CHU de Strasbourg(Hautepierre),Gynéco-Obstétrique (HTP),0,0,29,29,14,0,0
19/05/2013,Clinique des 3 Frontières,UPATOU (Structure des urgences),1,4,44,49,5,0,0
19/05/2013,Clinique des Diaconesses,SOS Main,0,2,19,21,1,0,0
19/05/2013,Clinique Ste Odile (Strasbourg,UPATOU,0,4,76,80,0,10,1
19/05/2013,CMCO,GYNECO-OBSTETRIQUE,0,0,0,0,0,0,0
19/05/2013,SIHCUS/CMCO,GYNECOLOGIE ET OBSTETRIQUE - CMCO,0,0,0,0,0,0,0
18/05/2013,CCOM,CCOM Chirurgie,0,2,31,33,3,0,0
18/05/2013,CH Altkirch,Upatou,1,5,36,42,8,1,1
18/05/2013,CH de Colmar (CMC Le Parc),SAU Le Parc,6,0,54,60,9,0,0
18/05/2013,CH de Colmar (Louis Pasteur),SAU Pasteur,0,19,126,145,34,12,3
18/05/2013,CH de Mulhouse ( Hasenrain),PEDIATRIE NEONATOLOGIE,9,0,29,38,6,1,0
18/05/2013,CH de Mulhouse (Emile Muller-Moenschberg,URGENCES,0,35,143,178,20,9,4
18/05/2013,CH de Saverne,S.A.U. (ADULTES),0,11,55,66,8,5,2
18/05/2013,CH de Saverne,PEDIATRIE,4,0,17,21,2,1,0
18/05/2013,CH de Sélestat,Acceuil des urgences,1,12,77,90,19,7,5
18/05/2013,CH de Thann,Urgences,0,8,34,42,8,0,3
18/05/2013,CHU de Strasbourg (Hôp. Civil),Urgences Médico-Chirurgicales NHC,0,20,105,125,51,4,1
18/05/2013,CHU de Strasbourg(Hautepierre),Urgences chirurgicales pédiatriques,15,0,41,56,10,10,0
18/05/2013,CHU de Strasbourg(Hautepierre),Gynéco-Obstétrique (HTP),0,0,25,25,7,0,0
18/05/2013,CHU de Strasbourg(Hautepierre),Urgences chirurgicales pédiatriques,1,0,62,63,7,6,0
18/05/2013,CHU de Strasbourg(Hautepierre),Urgences Adulte HTP,0,24,73,97,47,0,0
18/05/2013,Clinique des 3 Frontières,UPATOU (Structure des urgences),2,2,46,50,4,0,1
18/05/2013,Clinique des Diaconesses,SOS Main,0,1,36,37,0,0,0
18/05/2013,Clinique Ste Odile (Strasbourg,UPATOU,1,5,73,79,4,5,4
18/05/2013,CMCO,GYNECO-OBSTETRIQUE,0,0,0,0,0,0,0
18/05/2013,SIHCUS/CMCO,GYNECOLOGIE ET OBSTETRIQUE - CMCO,0,0,0,0,0,0,0
17/05/2013,CCOM,CCOM Chirurgie,0,2,28,30,3,0,0
17/05/2013,CH Altkirch,Upatou,0,4,28,32,4,0,2
17/05/2013,CH de Colmar (CMC Le Parc),SAU Le Parc,5,0,34,39,7,0,0
17/05/2013,CH de Colmar (Louis Pasteur),SAU Pasteur,0,16,106,122,25,10,2
17/05/2013,CH de Guebwiller,UHTCD,0,3,29,32,1,1,1
17/05/2013,CH de Mulhouse ( Hasenrain),PEDIATRIE NEONATOLOGIE,5,0,29,34,11,2,0
17/05/2013,CH de Mulhouse (Emile Muller-Moenschberg,URGENCES,1,25,122,148,19,12,1
17/05/2013,CH de Saverne,PEDIATRIE,4,0,9,13,1,0,0
17/05/2013,CH de Saverne,S.A.U. (ADULTES),0,15,38,53,12,6,2
17/05/2013,CH de Sélestat,Acceuil des urgences,0,10,68,78,11,5,0
17/05/2013,CH de Thann,Urgences,0,4,35,39,4,1,4
17/05/2013,CHU de Strasbourg (Hôp. Civil),Urgences Médico-Chirurgicales NHC,0,24,53,77,44,3,1
17/05/2013,CHU de Strasbourg(Hautepierre),Urgences chirurgicales pédiatriques,10,0,38,48,9,9,0
17/05/2013,CHU de Strasbourg(Hautepierre),Gynéco-Obstétrique (HTP),0,0,31,31,14,0,0
17/05/2013,CHU de Strasbourg(Hautepierre),Urgences Adulte HTP,0,22,82,104,42,0,1
17/05/2013,CHU de Strasbourg(Hautepierre),Urgences chirurgicales pédiatriques,4,0,47,51,3,2,0
17/05/2013,Clinique des 3 Frontières,UPATOU (Structure des urgences),0,0,37,37,2,0,1
17/05/2013,Clinique des Diaconesses,SOS Main,0,0,37,37,0,0,0
17/05/2013,Clinique Ste Odile (Strasbourg,UPATOU,1,8,52,61,1,3,0
17/05/2013,CMCO,GYNECO-OBSTETRIQUE,0,0,0,0,0,0,0
17/05/2013,SIHCUS/CMCO,GYNECOLOGIE ET OBSTETRIQUE - CMCO,0,0,0,0,0,0,0
16/05/2013,CCOM,CCOM Chirurgie,0,0,26,26,3,0,0
16/05/2013,CH Altkirch,Upatou,0,4,24,28,2,0,1
16/05/2013,CH de Colmar (CMC Le Parc),SAU Le Parc,6,0,45,51,7,0,0
16/05/2013,CH de Colmar (Louis Pasteur),SAU Pasteur,0,28,83,111,17,13,1
16/05/2013,CH de Guebwiller,UHTCD,0,5,46,51,1,5,0
16/05/2013,CH de Mulhouse ( Hasenrain),PEDIATRIE NEONATOLOGIE,11,0,19,30,4,1,0
16/05/2013,CH de Mulhouse (Emile Muller-Moenschberg,URGENCES,1,23,111,135,19,13,4
16/05/2013,CH de Saverne,S.A.U. (ADULTES),0,16,48,64,17,9,2
16/05/2013,CH de Saverne,PEDIATRIE,6,0,15,21,2,1,0
16/05/2013,CH de Sélestat,Acceuil des urgences,1,14,75,90,10,4,5
16/05/2013,CH de Thann,Urgences,0,5,33,38,4,1,0
16/05/2013,CH de Wissembourg,Urgences ,0,3,34,37,7,0,0
16/05/2013,CHU de Strasbourg (Hôp. Civil),Urgences Médico-Chirurgicales NHC,0,23,69,92,49,7,0
16/05/2013,CHU de Strasbourg(Hautepierre),Urgences chirurgicales pédiatriques,3,0,48,51,2,2,0
16/05/2013,CHU de Strasbourg(Hautepierre),Urgences Adulte HTP,0,16,72,88,34,0,2
16/05/2013,CHU de Strasbourg(Hautepierre),Urgences chirurgicales pédiatriques,11,0,32,43,6,6,0
16/05/2013,CHU de Strasbourg(Hautepierre),Gynéco-Obstétrique (HTP),0,0,30,30,10,0,0
16/05/2013,Clinique des 3 Frontières,UPATOU (Structure des urgences),0,2,40,42,5,0,0
16/05/2013,Clinique des Diaconesses,SOS Main,0,3,27,30,1,0,0
16/05/2013,Clinique Ste Odile (Strasbourg,UPATOU,0,4,71,75,3,6,1
16/05/2013,CMCO,GYNECO-OBSTETRIQUE,0,0,0,0,0,0,0
16/05/2013,SIHCUS/CMCO,GYNECOLOGIE ET OBSTETRIQUE - CMCO,0,0,0,0,0,0,0
15/05/2013,CCOM,CCOM Chirurgie,0,2,29,31,4,0,0
15/05/2013,CH Altkirch,Upatou,0,7,32,39,4,0,2
15/05/2013,CH de Colmar (CMC Le Parc),SAU Le Parc,5,0,27,32,2,0,0
15/05/2013,CH de Colmar (Louis Pasteur),SAU Pasteur,0,27,95,122,20,13,1
15/05/2013,CH de Guebwiller,UHTCD,0,2,45,47,0,2,0
15/05/2013,CH de Mulhouse ( Hasenrain),PEDIATRIE NEONATOLOGIE,8,0,16,24,0,1,0
15/05/2013,CH de Mulhouse (Emile Muller-Moenschberg,URGENCES,1,22,106,129,12,10,1
15/05/2013,CH de Saverne,PEDIATRIE,6,0,15,21,5,0,0
15/05/2013,CH de Saverne,S.A.U. (ADULTES),0,12,37,49,8,8,5
15/05/2013,CH de Sélestat,Acceuil des urgences,2,13,62,77,10,9,1
15/05/2013,CH de Thann,Urgences,0,8,21,29,8,1,0
15/05/2013,CH de Wissembourg,Urgences ,0,7,19,26,5,2,0
15/05/2013,CHU de Strasbourg (Hôp. Civil),Urgences Médico-Chirurgicales NHC,0,16,65,81,34,7,2
15/05/2013,CHU de Strasbourg(Hautepierre),Urgences chirurgicales pédiatriques,17,0,32,49,6,5,0
15/05/2013,CHU de Strasbourg(Hautepierre),Gynéco-Obstétrique (HTP),0,0,26,26,12,0,0
15/05/2013,CHU de Strasbourg(Hautepierre),Urgences chirurgicales pédiatriques,2,0,67,69,3,3,0
15/05/2013,CHU de Strasbourg(Hautepierre),Urgences Adulte HTP,0,20,72,92,34,0,0
15/05/2013,Clinique des 3 Frontières,UPATOU (Structure des urgences),0,2,33,35,4,0,0
15/05/2013,Clinique des Diaconesses,SOS Main,0,1,30,31,0,0,0
15/05/2013,Clinique Ste Odile (Strasbourg,UPATOU,0,1,71,72,4,6,0
15/05/2013,CMCO,GYNECO-OBSTETRIQUE,0,0,0,0,0,0,0
15/05/2013,SIHCUS/CMCO,GYNECOLOGIE ET OBSTETRIQUE - CMCO,0,0,0,0,0,0,0
14/05/2013,CCOM,CCOM Chirurgie,0,2,28,30,2,0,0
14/05/2013,CH Altkirch,Upatou,0,4,38,42,4,1,1
14/05/2013,CH de Colmar (CMC Le Parc),SAU Le Parc,10,0,34,44,7,0,0
14/05/2013,CH de Colmar (Louis Pasteur),SAU Pasteur,0,27,101,128,15,8,0
14/05/2013,CH de Guebwiller,UHTCD,0,6,40,46,6,1,2
14/05/2013,CH de Mulhouse ( Hasenrain),PEDIATRIE NEONATOLOGIE,12,0,21,33,5,1,1
14/05/2013,CH de Mulhouse (Emile Muller-Moenschberg,URGENCES,0,26,97,123,11,14,3
14/05/2013,CH de Saverne,S.A.U. (ADULTES),0,10,53,63,12,6,1
14/05/2013,CH de Saverne,PEDIATRIE,5,0,15,20,1,2,0
14/05/2013,CH de Sélestat,Acceuil des urgences,1,9,66,76,11,3,3
14/05/2013,CH de Thann,Urgences,0,5,32,37,4,0,0
14/05/2013,CH de Wissembourg,Urgences ,0,14,29,43,14,2,2
14/05/2013,CHU de Strasbourg (Hôp. Civil),Urgences Médico-Chirurgicales NHC,0,18,59,77,50,1,2
14/05/2013,CHU de Strasbourg(Hautepierre),Urgences chirurgicales pédiatriques,15,0,31,46,7,7,0
14/05/2013,CHU de Strasbourg(Hautepierre),Urgences Adulte HTP,0,17,95,112,46,0,0
14/05/2013,CHU de Strasbourg(Hautepierre),Gynéco-Obstétrique (HTP),2,0,27,29,11,0,0
14/05/2013,CHU de Strasbourg(Hautepierre),Urgences chirurgicales pédiatriques,5,0,57,62,4,3,0
14/05/2013,Clinique des 3 Frontières,UPATOU (Structure des urgences),0,2,36,38,2,1,0
14/05/2013,Clinique des Diaconesses,SOS Main,0,2,35,37,0,0,0
14/05/2013,Clinique Ste Odile (Strasbourg,UPATOU,0,5,69,74,6,12,3
14/05/2013,CMCO,GYNECO-OBSTETRIQUE,0,0,0,0,0,0,0
14/05/2013,SIHCUS/CMCO,GYNECOLOGIE ET OBSTETRIQUE - CMCO,0,0,0,0,0,0,0
13/05/2013,CCOM,CCOM Chirurgie,0,3,28,31,3,0,0
13/05/2013,CH Altkirch,Upatou,0,6,42,48,5,1,1
13/05/2013,CH de Colmar (CMC Le Parc),SAU Le Parc,10,0,40,50,7,0,0
13/05/2013,CH de Colmar (Louis Pasteur),SAU Pasteur,0,30,100,130,21,13,1
13/05/2013,CH de Guebwiller,UHTCD,0,4,32,36,1,1,1
13/05/2013,CH de Mulhouse ( Hasenrain),PEDIATRIE NEONATOLOGIE,9,0,27,36,8,3,0
13/05/2013,CH de Mulhouse (Emile Muller-Moenschberg,URGENCES,1,23,96,120,17,5,4
13/05/2013,CH de Saverne,S.A.U. (ADULTES),0,12,48,60,18,4,0
13/05/2013,CH de Saverne,PEDIATRIE,0,0,13,13,3,0,0
13/05/2013,CH de Sélestat,Acceuil des urgences,1,8,76,85,12,3,3
13/05/2013,CH de Thann,Urgences,0,2,30,32,1,1,1
13/05/2013,CH de Wissembourg,Urgences ,0,8,38,46,12,1,1
13/05/2013,CHU de Strasbourg (Hôp. Civil),Urgences Médico-Chirurgicales NHC,0,17,66,83,45,3,1
13/05/2013,CHU de Strasbourg(Hautepierre),Urgences chirurgicales pédiatriques,12,0,41,53,11,12,0
13/05/2013,CHU de Strasbourg(Hautepierre),Gynéco-Obstétrique (HTP),1,0,29,30,16,0,0
13/05/2013,CHU de Strasbourg(Hautepierre),Urgences Adulte HTP,0,15,96,111,39,0,0
13/05/2013,CHU de Strasbourg(Hautepierre),Urgences chirurgicales pédiatriques,3,0,51,54,2,1,0
13/05/2013,Clinique des 3 Frontières,UPATOU (Structure des urgences),1,5,34,40,3,1,1
13/05/2013,Clinique des Diaconesses,SOS Main,0,2,39,41,1,0,0
13/05/2013,Clinique Ste Odile (Strasbourg,UPATOU,0,9,59,68,0,7,0
13/05/2013,CMCO,GYNECO-OBSTETRIQUE,0,0,0,0,0,0,0
13/05/2013,SIHCUS/CMCO,GYNECOLOGIE ET OBSTETRIQUE - CMCO,0,0,0,0,0,0,0
12/05/2013,CCOM,CCOM Chirurgie,0,2,9,11,0,0,0
12/05/2013,CH Altkirch,Upatou,1,8,25,34,4,1,0
12/05/2013,CH de Colmar (CMC Le Parc),SAU Le Parc,7,0,57,64,9,0,0
12/05/2013,CH de Colmar (Louis Pasteur),SAU Pasteur,0,12,112,124,23,9,0
12/05/2013,CH de Guebwiller,UHTCD,0,1,48,49,1,1,2
12/05/2013,CH de Mulhouse ( Hasenrain),PEDIATRIE NEONATOLOGIE,11,0,33,44,5,1,0
12/05/2013,CH de Mulhouse (Emile Muller-Moenschberg,URGENCES,0,15,111,126,10,9,3
12/05/2013,CH de Saverne,PEDIATRIE,5,0,13,18,1,0,0
12/05/2013,CH de Saverne,S.A.U. (ADULTES),0,10,40,50,6,5,0
12/05/2013,CH de Sélestat,Acceuil des urgences,2,7,86,95,12,3,5
12/05/2013,CH de Thann,Urgences,0,6,47,53,2,0,0
12/05/2013,CH de Wissembourg,Urgences ,0,1,34,35,3,1,0
12/05/2013,CHU de Strasbourg (Hôp. Civil),Urgences Médico-Chirurgicales NHC,0,15,83,98,27,3,2
12/05/2013,CHU de Strasbourg(Hautepierre),Urgences chirurgicales pédiatriques,2,0,63,65,7,6,0
12/05/2013,CHU de Strasbourg(Hautepierre),Urgences chirurgicales pédiatriques,15,0,40,55,4,4,0
12/05/2013,CHU de Strasbourg(Hautepierre),Gynéco-Obstétrique (HTP),1,0,19,20,7,0,0
12/05/2013,CHU de Strasbourg(Hautepierre),Urgences Adulte HTP,0,12,77,89,23,0,1
12/05/2013,Clinique des 3 Frontières,UPATOU (Structure des urgences),0,6,42,48,4,0,0
12/05/2013,Clinique des Diaconesses,SOS Main,0,4,22,26,0,0,0
12/05/2013,Clinique Ste Odile (Strasbourg,UPATOU,1,2,79,82,0,4,0
12/05/2013,CMCO,GYNECO-OBSTETRIQUE,0,0,0,0,0,0,0
12/05/2013,SIHCUS/CMCO,GYNECOLOGIE ET OBSTETRIQUE - CMCO,0,0,0,0,0,0,0
11/05/2013,CCOM,CCOM Chirurgie,0,2,17,19,5,0,0
11/05/2013,CH Altkirch,Upatou,0,3,34,37,2,2,2
11/05/2013,CH de Colmar (CMC Le Parc),SAU Le Parc,7,0,50,57,6,0,0
11/05/2013,CH de Colmar (Louis Pasteur),SAU Pasteur,0,21,129,150,25,10,1
11/05/2013,CH de Guebwiller,UHTCD,0,2,30,32,4,2,1
11/05/2013,CH de Mulhouse ( Hasenrain),PEDIATRIE NEONATOLOGIE,10,0,30,40,7,1,0
11/05/2013,CH de Mulhouse (Emile Muller-Moenschberg,URGENCES,0,29,121,150,16,15,1
11/05/2013,CH de Saverne,PEDIATRIE,1,0,15,16,2,0,0
11/05/2013,CH de Saverne,S.A.U. (ADULTES),0,11,42,53,10,4,2
11/05/2013,CH de Sélestat,Acceuil des urgences,2,12,70,84,10,3,1
11/05/2013,CH de Thann,Urgences,0,9,50,59,2,3,3
11/05/2013,CH de Wissembourg,Urgences ,0,3,42,45,6,0,2
11/05/2013,CHU de Strasbourg (Hôp. Civil),Urgences Médico-Chirurgicales NHC,0,20,89,109,38,7,3
11/05/2013,CHU de Strasbourg(Hautepierre),Urgences Adulte HTP,0,6,90,96,29,0,0
11/05/2013,CHU de Strasbourg(Hautepierre),Urgences chirurgicales pédiatriques,11,0,58,69,15,14,1
11/05/2013,CHU de Strasbourg(Hautepierre),Gynéco-Obstétrique (HTP),0,0,27,27,11,0,0
11/05/2013,CHU de Strasbourg(Hautepierre),Urgences chirurgicales pédiatriques,2,0,55,57,5,5,0
11/05/2013,Clinique des 3 Frontières,UPATOU (Structure des urgences),2,7,50,59,5,0,0
11/05/2013,Clinique des Diaconesses,SOS Main,0,2,27,29,0,0,0
11/05/2013,Clinique Ste Odile (Strasbourg,UPATOU,3,3,91,97,0,6,2
11/05/2013,CMCO,GYNECO-OBSTETRIQUE,0,0,0,0,0,0,0
11/05/2013,SIHCUS/CMCO,GYNECOLOGIE ET OBSTETRIQUE - CMCO,0,0,0,0,0,0,0
10/05/2013,CCOM,CCOM Chirurgie,0,2,23,25,4,0,0
10/05/2013,CH Altkirch,Upatou,0,5,33,38,4,1,1
10/05/2013,CH de Colmar (CMC Le Parc),SAU Le Parc,9,0,47,56,9,0,1
10/05/2013,CH de Colmar (Louis Pasteur),SAU Pasteur,0,27,129,156,24,11,3
10/05/2013,CH de Guebwiller,UHTCD,0,5,44,49,1,2,1
10/05/2013,CH de Mulhouse ( Hasenrain),PEDIATRIE NEONATOLOGIE,17,0,30,47,7,1,0
10/05/2013,CH de Mulhouse (Emile Muller-Moenschberg,URGENCES,0,24,135,159,11,9,1
10/05/2013,CH de Saverne,PEDIATRIE,5,0,24,29,0,2,0
10/05/2013,CH de Saverne,S.A.U. (ADULTES),0,12,42,54,12,7,1
10/05/2013,CH de Sélestat,Acceuil des urgences,4,10,87,101,19,5,3
10/05/2013,CH de Thann,Urgences,1,14,39,54,3,3,3
10/05/2013,CH de Wissembourg,Urgences ,0,6,31,37,7,0,3
10/05/2013,CHU de Strasbourg (Hôp. Civil),Urgences Médico-Chirurgicales NHC,0,22,59,81,50,10,2
10/05/2013,CHU de Strasbourg(Hautepierre),Urgences chirurgicales pédiatriques,0,0,51,51,1,1,0
10/05/2013,CHU de Strasbourg(Hautepierre),Urgences Adulte HTP,0,18,80,98,39,0,0
10/05/2013,CHU de Strasbourg(Hautepierre),Urgences chirurgicales pédiatriques,9,0,26,35,5,5,0
10/05/2013,CHU de Strasbourg(Hautepierre),Gynéco-Obstétrique (HTP),0,0,26,26,9,0,0
10/05/2013,Clinique des 3 Frontières,UPATOU (Structure des urgences),1,4,37,42,6,0,1
10/05/2013,Clinique des Diaconesses,SOS Main,0,5,32,37,0,0,1
10/05/2013,Clinique Ste Odile (Strasbourg,UPATOU,0,7,84,91,3,6,2
10/05/2013,CMCO,GYNECO-OBSTETRIQUE,0,0,0,0,0,0,0
10/05/2013,SIHCUS/CMCO,GYNECOLOGIE ET OBSTETRIQUE - CMCO,0,0,0,0,0,0,0
9/05/2013,CCOM,CCOM Chirurgie,0,0,19,19,4,0,0
9/05/2013,CH Altkirch,Upatou,0,1,50,51,4,2,0
9/05/2013,CH de Colmar (CMC Le Parc),SAU Le Parc,7,0,57,64,11,0,0
9/05/2013,CH de Colmar (Louis Pasteur),SAU Pasteur,0,30,127,157,19,9,0
9/05/2013,CH de Guebwiller,UHTCD,1,3,52,56,0,3,0
9/05/2013,CH de Mulhouse ( Hasenrain),PEDIATRIE NEONATOLOGIE,10,0,28,38,8,1,0
9/05/2013,CH de Mulhouse (Emile Muller-Moenschberg,URGENCES,1,24,127,152,14,13,3
9/05/2013,CH de Saverne,S.A.U. (ADULTES),0,6,50,56,7,5,0
9/05/2013,CH de Saverne,PEDIATRIE,3,0,30,33,2,1,0
9/05/2013,CH de Sélestat,Acceuil des urgences,1,9,80,90,12,3,2
9/05/2013,CH de Thann,Urgences,1,6,49,56,1,1,2
9/05/2013,CH de Wissembourg,Urgences ,1,5,39,45,8,1,2
9/05/2013,CHU de Strasbourg (Hôp. Civil),Urgences Médico-Chirurgicales NHC,0,15,73,88,25,2,1
9/05/2013,CHU de Strasbourg(Hautepierre),Gynéco-Obstétrique (HTP),0,0,38,38,14,0,0
9/05/2013,CHU de Strasbourg(Hautepierre),Urgences chirurgicales pédiatriques,1,0,68,69,4,3,0
9/05/2013,CHU de Strasbourg(Hautepierre),Urgences Adulte HTP,0,14,86,100,30,0,0
9/05/2013,CHU de Strasbourg(Hautepierre),Urgences chirurgicales pédiatriques,17,0,51,68,13,13,0
9/05/2013,Clinique des 3 Frontières,UPATOU (Structure des urgences),0,2,54,56,9,0,0
9/05/2013,Clinique des Diaconesses,SOS Main,0,0,29,29,0,0,0
9/05/2013,Clinique Ste Odile (Strasbourg,UPATOU,0,4,111,115,1,7,3
9/05/2013,CMCO,GYNECO-OBSTETRIQUE,0,0,0,0,0,0,0
9/05/2013,SIHCUS/CMCO,GYNECOLOGIE ET OBSTETRIQUE - CMCO,0,0,0,0,0,0,0
8/05/2013,CCOM,CCOM Chirurgie,0,1,21,22,2,0,0
8/05/2013,CH Altkirch,Upatou,0,4,40,44,4,2,0
8/05/2013,CH de Colmar (CMC Le Parc),SAU Le Parc,6,0,49,55,7,0,0
8/05/2013,CH de Colmar (Louis Pasteur),SAU Pasteur,0,25,92,117,9,11,0
8/05/2013,CH de Guebwiller,UHTCD,0,1,39,40,0,3,0
8/05/2013,CH de Mulhouse ( Hasenrain),PEDIATRIE NEONATOLOGIE,13,0,32,45,5,0,0
8/05/2013,CH de Mulhouse (Emile Muller-Moenschberg,URGENCES,0,25,144,169,26,11,4
8/05/2013,CH de Saverne,S.A.U. (ADULTES),0,14,48,62,12,2,4
8/05/2013,CH de Saverne,PEDIATRIE,6,0,20,26,1,1,0
8/05/2013,CH de Sélestat,Acceuil des urgences,1,14,73,88,10,3,5
8/05/2013,CH de Thann,Urgences,0,3,40,43,1,0,4
8/05/2013,CH de Wissembourg,Urgences ,0,5,32,37,7,0,1
8/05/2013,CHU de Strasbourg (Hôp. Civil),Urgences Médico-Chirurgicales NHC,1,14,94,109,28,5,1
8/05/2013,CHU de Strasbourg(Hautepierre),Urgences chirurgicales pédiatriques,2,0,48,50,3,3,0
8/05/2013,CHU de Strasbourg(Hautepierre),Urgences chirurgicales pédiatriques,11,0,39,50,7,6,0
8/05/2013,CHU de Strasbourg(Hautepierre),Gynéco-Obstétrique (HTP),0,0,31,31,10,0,0
8/05/2013,CHU de Strasbourg(Hautepierre),Urgences Adulte HTP,0,12,90,102,24,0,0
8/05/2013,Clinique des 3 Frontières,UPATOU (Structure des urgences),1,1,66,68,4,0,1
8/05/2013,Clinique des Diaconesses,SOS Main,0,0,29,29,12,0,0
8/05/2013,Clinique Ste Odile (Strasbourg,UPATOU,1,4,82,87,0,5,3
8/05/2013,CMCO,GYNECO-OBSTETRIQUE,0,0,0,0,0,0,0
8/05/2013,SIHCUS/CMCO,GYNECOLOGIE ET OBSTETRIQUE - CMCO,0,0,0,0,0,0,0
7/05/2013,CCOM,CCOM Chirurgie,0,3,15,18,1,0,0
7/05/2013,CH Altkirch,Upatou,0,5,38,43,9,1,2
7/05/2013,CH de Colmar (CMC Le Parc),SAU Le Parc,7,0,37,44,6,0,0
7/05/2013,CH de Colmar (Louis Pasteur),SAU Pasteur,0,25,105,130,26,11,2
7/05/2013,CH de Guebwiller,UHTCD,0,2,40,42,0,0,3
7/05/2013,CH de Mulhouse ( Hasenrain),PEDIATRIE NEONATOLOGIE,13,0,23,36,6,1,0
7/05/2013,CH de Mulhouse (Emile Muller-Moenschberg,URGENCES,3,25,130,158,18,9,1
7/05/2013,CH de Saverne,PEDIATRIE,3,0,14,17,1,2,0
7/05/2013,CH de Saverne,S.A.U. (ADULTES),0,11,42,53,9,9,0
7/05/2013,CH de Sélestat,Acceuil des urgences,2,18,85,105,15,3,4
7/05/2013,CH de Thann,Urgences,0,5,47,52,3,2,2
7/05/2013,CH de Wissembourg,Urgences ,2,6,25,33,5,0,2
7/05/2013,CHU de Strasbourg (Hôp. Civil),Urgences Médico-Chirurgicales NHC,0,29,68,97,50,8,3
7/05/2013,CHU de Strasbourg(Hautepierre),Urgences chirurgicales pédiatriques,4,0,42,46,3,3,0
7/05/2013,CHU de Strasbourg(Hautepierre),Urgences chirurgicales pédiatriques,10,0,47,57,3,3,0
7/05/2013,CHU de Strasbourg(Hautepierre),Gynéco-Obstétrique (HTP),0,0,22,22,4,0,0
7/05/2013,CHU de Strasbourg(Hautepierre),Urgences Adulte HTP,0,18,88,106,40,0,0
7/05/2013,Clinique des 3 Frontières,UPATOU (Structure des urgences),1,7,48,56,6,0,0
7/05/2013,Clinique des Diaconesses,SOS Main,0,1,40,41,14,0,0
7/05/2013,Clinique Ste Odile (Strasbourg,UPATOU,0,3,56,59,2,8,3
7/05/2013,CMCO,GYNECO-OBSTETRIQUE,0,0,0,0,0,0,0
7/05/2013,SIHCUS/CMCO,GYNECOLOGIE ET OBSTETRIQUE - CMCO,0,0,25,25,0,0,0
6/05/2013,CCOM,CCOM Chirurgie,0,3,30,33,2,0,0
6/05/2013,CH Altkirch,Upatou,0,5,39,44,4,0,2
6/05/2013,CH de Colmar (CMC Le Parc),SAU Le Parc,7,0,46,53,10,0,0
6/05/2013,CH de Colmar (Louis Pasteur),SAU Pasteur,0,29,120,149,13,9,1
6/05/2013,CH de Guebwiller,UHTCD,0,3,40,43,3,3,6
6/05/2013,CH de Mulhouse ( Hasenrain),PEDIATRIE NEONATOLOGIE,10,0,31,41,5,0,0
6/05/2013,CH de Mulhouse (Emile Muller-Moenschberg,URGENCES,2,26,107,135,16,12,5
6/05/2013,CH de Saverne,S.A.U. (ADULTES),0,18,47,65,9,9,2
6/05/2013,CH de Saverne,PEDIATRIE,7,0,10,17,2,0,0
6/05/2013,CH de Sélestat,Acceuil des urgences,1,11,86,98,16,4,0
6/05/2013,CH de Thann,Urgences,0,8,49,57,7,1,2
6/05/2013,CH de Wissembourg,Urgences ,0,8,28,36,10,0,0
6/05/2013,CHU de Strasbourg (Hôp. Civil),Urgences Médico-Chirurgicales NHC,0,15,78,93,48,8,0
6/05/2013,CHU de Strasbourg(Hautepierre),Urgences chirurgicales pédiatriques,8,0,33,41,9,9,0
6/05/2013,CHU de Strasbourg(Hautepierre),Gynéco-Obstétrique (HTP),0,1,22,23,14,0,0
6/05/2013,CHU de Strasbourg(Hautepierre),Urgences Adulte HTP,0,24,93,117,51,0,0
6/05/2013,CHU de Strasbourg(Hautepierre),Urgences chirurgicales pédiatriques,2,0,66,68,3,3,0
6/05/2013,Clinique des 3 Frontières,UPATOU (Structure des urgences),3,10,38,51,5,1,2
6/05/2013,Clinique des Diaconesses,SOS Main,0,3,45,48,2,0,0
6/05/2013,Clinique Ste Odile (Strasbourg,UPATOU,0,6,67,73,1,5,3
6/05/2013,CMCO,GYNECO-OBSTETRIQUE,0,0,0,0,0,0,0
6/05/2013,SIHCUS/CMCO,GYNECOLOGIE ET OBSTETRIQUE - CMCO,0,0,0,0,0,0,0
5/05/2013,CCOM,CCOM Chirurgie,0,3,21,24,6,0,0
5/05/2013,CH Altkirch,Upatou,0,10,39,49,8,1,1
5/05/2013,CH de Colmar (CMC Le Parc),SAU Le Parc,11,0,49,60,6,0,0
5/05/2013,CH de Colmar (Louis Pasteur),SAU Pasteur,0,19,108,127,23,15,0
5/05/2013,CH de Guebwiller,UHTCD,0,3,50,53,0,2,3
5/05/2013,CH de Mulhouse ( Hasenrain),PEDIATRIE NEONATOLOGIE,6,0,29,35,5,2,0
5/05/2013,CH de Mulhouse (Emile Muller-Moenschberg,URGENCES,1,22,130,153,27,10,3
5/05/2013,CH de Saverne,S.A.U. (ADULTES),0,11,60,71,15,4,0
5/05/2013,CH de Saverne,PEDIATRIE,6,0,15,21,3,1,0
5/05/2013,CH de Sélestat,Acceuil des urgences,2,7,90,99,17,5,1
5/05/2013,CH de Thann,Urgences,0,6,36,42,0,1,1
5/05/2013,CH de Wissembourg,Urgences ,0,11,53,64,10,1,2
5/05/2013,CHU de Strasbourg (Hôp. Civil),Urgences Médico-Chirurgicales NHC,0,12,92,104,46,1,0
5/05/2013,CHU de Strasbourg(Hautepierre),Urgences chirurgicales pédiatriques,2,0,58,60,5,5,0
5/05/2013,CHU de Strasbourg(Hautepierre),Urgences Adulte HTP,0,15,95,110,21,0,1
5/05/2013,CHU de Strasbourg(Hautepierre),Urgences chirurgicales pédiatriques,10,0,38,48,5,4,0
5/05/2013,CHU de Strasbourg(Hautepierre),Gynéco-Obstétrique (HTP),0,0,17,17,4,0,0
5/05/2013,Clinique des 3 Frontières,UPATOU (Structure des urgences),0,3,50,53,4,0,3
5/05/2013,Clinique Ste Odile (Strasbourg,UPATOU,0,3,90,93,1,4,4
5/05/2013,CMCO,GYNECO-OBSTETRIQUE,0,0,0,0,0,0,0
5/05/2013,SIHCUS/CMCO,GYNECOLOGIE ET OBSTETRIQUE - CMCO,0,0,0,0,0,0,0
4/05/2013,CCOM,CCOM Chirurgie,0,2,23,25,5,0,0
4/05/2013,CH Altkirch,Upatou,0,8,31,39,6,0,5
4/05/2013,CH de Colmar (CMC Le Parc),SAU Le Parc,6,0,34,40,4,0,0
4/05/2013,CH de Colmar (Louis Pasteur),SAU Pasteur,0,22,119,141,23,10,2
4/05/2013,CH de Guebwiller,UHTCD,0,5,37,42,0,3,1
4/05/2013,CH de Mulhouse ( Hasenrain),PEDIATRIE NEONATOLOGIE,11,0,25,36,2,0,0
4/05/2013,CH de Mulhouse (Emile Muller-Moenschberg,URGENCES,0,26,90,116,20,7,0
4/05/2013,CH de Saverne,PEDIATRIE,7,0,13,20,4,0,0
4/05/2013,CH de Saverne,S.A.U. (ADULTES),0,17,44,61,15,4,1
4/05/2013,CH de Sélestat,Acceuil des urgences,2,19,72,93,21,5,0
4/05/2013,CH de Thann,Urgences,0,12,39,51,5,0,3
4/05/2013,CH de Wissembourg,Urgences ,0,13,47,60,13,2,1
4/05/2013,CHU de Strasbourg (Hôp. Civil),Urgences Médico-Chirurgicales NHC,0,22,83,105,45,2,1
4/05/2013,CHU de Strasbourg(Hautepierre),Urgences chirurgicales pédiatriques,3,0,59,62,4,4,0
4/05/2013,CHU de Strasbourg(Hautepierre),Urgences Adulte HTP,0,20,79,99,26,0,0
4/05/2013,CHU de Strasbourg(Hautepierre),Urgences chirurgicales pédiatriques,9,0,42,51,7,6,0
4/05/2013,CHU de Strasbourg(Hautepierre),Gynéco-Obstétrique (HTP),0,1,22,23,8,0,0
4/05/2013,Clinique des 3 Frontières,UPATOU (Structure des urgences),2,5,42,49,5,0,0
4/05/2013,Clinique des Diaconesses,SOS Main,0,1,18,19,1,0,0
4/05/2013,Clinique Ste Odile (Strasbourg,UPATOU,0,7,67,74,2,5,1
4/05/2013,CMCO,GYNECO-OBSTETRIQUE,0,0,0,0,0,0,0
4/05/2013,SIHCUS/CMCO,GYNECOLOGIE ET OBSTETRIQUE - CMCO,0,0,0,0,0,0,0
3/05/2013,CCOM,CCOM Chirurgie,0,0,28,28,6,0,0
3/05/2013,CH Altkirch,Upatou,0,6,21,27,3,0,1
3/05/2013,CH de Colmar (CMC Le Parc),SAU Le Parc,5,0,36,41,16,0,0
3/05/2013,CH de Colmar (Louis Pasteur),SAU Pasteur,0,24,105,129,26,9,0
3/05/2013,CH de Guebwiller,UHTCD,0,3,40,43,2,0,3
3/05/2013,CH de Mulhouse ( Hasenrain),PEDIATRIE NEONATOLOGIE,9,0,22,31,6,0,0
3/05/2013,CH de Mulhouse (Emile Muller-Moenschberg,URGENCES,2,20,88,110,10,13,1
3/05/2013,CH de Saverne,PEDIATRIE,2,0,12,14,3,2,0
3/05/2013,CH de Saverne,S.A.U. (ADULTES),0,18,33,51,17,3,2
3/05/2013,CH de Sélestat,Acceuil des urgences,3,12,67,82,13,3,5
3/05/2013,CH de Thann,Urgences,0,3,32,35,1,1,2
3/05/2013,CH de Wissembourg,Urgences ,0,17,42,59,7,1,1
3/05/2013,CHU de Strasbourg (Hôp. Civil),Urgences Médico-Chirurgicales NHC,0,21,57,78,47,2,0
3/05/2013,CHU de Strasbourg(Hautepierre),Urgences chirurgicales pédiatriques,3,0,69,72,3,2,0
3/05/2013,CHU de Strasbourg(Hautepierre),Urgences Adulte HTP,0,24,83,107,40,0,0
3/05/2013,CHU de Strasbourg(Hautepierre),Urgences chirurgicales pédiatriques,10,0,42,52,5,5,0
3/05/2013,CHU de Strasbourg(Hautepierre),Gynéco-Obstétrique (HTP),0,0,27,27,13,0,0
3/05/2013,Clinique des 3 Frontières,UPATOU (Structure des urgences),1,5,31,37,6,0,0
3/05/2013,Clinique des Diaconesses,SOS Main,0,1,35,36,0,0,0
3/05/2013,Clinique Ste Odile (Strasbourg,UPATOU,0,5,66,71,1,4,0
3/05/2013,CMCO,GYNECO-OBSTETRIQUE,0,0,0,0,0,0,0
3/05/2013,SIHCUS/CMCO,GYNECOLOGIE ET OBSTETRIQUE - CMCO,0,0,0,0,0,0,0
2/05/2013,CCOM,CCOM Chirurgie,0,0,24,24,1,0,0
2/05/2013,CH Altkirch,Upatou,0,5,35,40,4,0,0
2/05/2013,CH de Colmar (CMC Le Parc),SAU Le Parc,7,0,49,56,3,0,0
2/05/2013,CH de Colmar (Louis Pasteur),SAU Pasteur,0,26,96,122,18,12,2
2/05/2013,CH de Guebwiller,UHTCD,0,7,52,59,3,4,2
2/05/2013,CH de Mulhouse ( Hasenrain),PEDIATRIE NEONATOLOGIE,12,0,30,42,10,1,0
2/05/2013,CH de Mulhouse (Emile Muller-Moenschberg,URGENCES,1,20,123,144,10,13,5
2/05/2013,CH de Saverne,PEDIATRIE,3,0,13,16,3,0,0
2/05/2013,CH de Saverne,S.A.U. (ADULTES),0,13,46,59,10,8,2
2/05/2013,CH de Sélestat,Acceuil des urgences,0,9,80,89,15,4,1
2/05/2013,CH de Thann,Urgences,0,1,41,42,3,0,0
2/05/2013,CH de Wissembourg,Urgences ,0,9,23,32,5,0,1
2/05/2013,CHU de Strasbourg (Hôp. Civil),Urgences Médico-Chirurgicales NHC,0,17,59,76,45,6,2
2/05/2013,CHU de Strasbourg(Hautepierre),Urgences chirurgicales pédiatriques,13,0,47,60,8,8,0
2/05/2013,CHU de Strasbourg(Hautepierre),Gynéco-Obstétrique (HTP),0,0,27,27,8,0,0
2/05/2013,CHU de Strasbourg(Hautepierre),Urgences Adulte HTP,0,20,86,106,55,0,0
2/05/2013,CHU de Strasbourg(Hautepierre),Urgences chirurgicales pédiatriques,1,0,69,70,3,3,0
2/05/2013,Clinique des 3 Frontières,UPATOU (Structure des urgences),0,5,39,44,4,0,1
2/05/2013,Clinique des Diaconesses,SOS Main,0,0,30,30,0,0,0
2/05/2013,Clinique Ste Odile (Strasbourg,UPATOU,0,5,67,72,1,6,2
2/05/2013,CMCO,GYNECO-OBSTETRIQUE,0,0,0,0,0,0,0
2/05/2013,SIHCUS/CMCO,GYNECOLOGIE ET OBSTETRIQUE - CMCO,0,0,0,0,0,0,0
31/07/2013,CH Altkirch,Upatou,0,3,32,35,3,0,1
31/07/2013,CH de Colmar (CMC Le Parc),SAU Le Parc,4,0,30,34,2,0,0
31/07/2013,CH de Colmar (Louis Pasteur),SAU Pasteur,1,25,112,138,22,14,0
31/07/2013,CH de Guebwiller,UHTCD,0,12,42,54,2,0,0
31/07/2013,CH de Mulhouse ( Hasenrain),PEDIATRIE NEONATOLOGIE,6,0,23,29,4,0,0
31/07/2013,CH de Mulhouse (Emile Muller-Moenschberg,URGENCES,3,26,108,137,10,12,5
31/07/2013,CH de Saverne,PEDIATRIE,8,0,8,16,2,3,0
31/07/2013,CH de Saverne,S.A.U. (ADULTES),0,8,41,49,10,5,0
31/07/2013,CH de Sélestat,Acceuil des urgences,0,11,63,74,11,5,1
31/07/2013,CH de Wissembourg,Urgences ,0,6,32,38,7,1,1
31/07/2013,CHU de Strasbourg(Hautepierre),Urgences Adulte HTP,0,28,64,92,43,14,1
31/07/2013,Clinique des 3 Frontières,UPATOU (Structure des urgences),0,8,36,44,7,0,0
31/07/2013,Clinique des Diaconesses,SOS Main,0,2,51,53,16,0,1
31/07/2013,Clinique Ste Odile (Strasbourg,UPATOU,0,1,76,77,1,0,0
31/07/2013,CMCO,GYNECO-OBSTETRIQUE,0,0,0,0,0,0,0
30/07/2013,CH Altkirch,Upatou,0,3,25,28,4,1,0
30/07/2013,CH de Colmar (CMC Le Parc),SAU Le Parc,8,0,36,44,7,0,0
30/07/2013,CH de Colmar (Louis Pasteur),SAU Pasteur,1,26,88,115,26,8,0
30/07/2013,CH de Guebwiller,UHTCD,1,5,41,47,1,5,1
30/07/2013,CH de Mulhouse ( Hasenrain),PEDIATRIE NEONATOLOGIE,7,0,16,23,2,0,0
30/07/2013,CH de Mulhouse (Emile Muller-Moenschberg,URGENCES,1,20,128,149,9,14,2
30/07/2013,CH de Saverne,S.A.U. (ADULTES),0,10,47,57,9,2,0
30/07/2013,CH de Saverne,PEDIATRIE,4,0,12,16,4,1,0
30/07/2013,CH de Sélestat,Acceuil des urgences,2,11,62,75,10,2,1
30/07/2013,CH de Thann,Urgences,2,3,28,33,0,3,0
30/07/2013,CH de Wissembourg,Urgences ,0,6,20,26,5,1,0
30/07/2013,CHU de Strasbourg(Hautepierre),Urgences Adulte HTP,0,15,88,103,23,16,2
30/07/2013,Clinique des 3 Frontières,UPATOU (Structure des urgences),1,7,42,50,5,0,1
30/07/2013,Clinique des Diaconesses,SOS Main,2,1,36,39,11,0,0
30/07/2013,Clinique Ste Odile (Strasbourg,UPATOU,0,5,59,64,0,2,0
30/07/2013,CMCO,GYNECO-OBSTETRIQUE,0,0,0,0,0,0,0
29/07/2013,CH Altkirch,Upatou,1,11,36,48,9,0,0
29/07/2013,CH de Colmar (CMC Le Parc),SAU Le Parc,5,0,53,58,7,0,0
29/07/2013,CH de Colmar (Louis Pasteur),SAU Pasteur,0,25,125,150,21,11,1
29/07/2013,CH de Guebwiller,UHTCD,0,3,48,51,1,1,1
29/07/2013,CH de Mulhouse ( Hasenrain),PEDIATRIE NEONATOLOGIE,11,0,19,30,2,1,0
29/07/2013,CH de Mulhouse (Emile Muller-Moenschberg,URGENCES,1,25,87,113,19,8,7
29/07/2013,CH de Saverne,S.A.U. (ADULTES),0,9,46,55,7,4,2
29/07/2013,CH de Saverne,PEDIATRIE,6,0,17,23,2,0,0
29/07/2013,CH de Sélestat,Acceuil des urgences,1,15,67,83,24,7,2
29/07/2013,CH de Thann,Urgences,0,7,48,55,3,1,2
29/07/2013,CH de Wissembourg,Urgences ,1,7,38,46,10,1,3
29/07/2013,CHU de Strasbourg(Hautepierre),Urgences Adulte HTP,0,11,82,93,15,7,1
29/07/2013,Clinique des 3 Frontières,UPATOU (Structure des urgences),0,1,45,46,9,0,1
29/07/2013,Clinique Ste Odile (Strasbourg,UPATOU,0,3,78,81,2,7,2
29/07/2013,CMCO,GYNECO-OBSTETRIQUE,0,0,0,0,0,0,0
28/07/2013,CH Altkirch,Upatou,0,5,33,38,5,1,3
28/07/2013,CH de Colmar (CMC Le Parc),SAU Le Parc,10,0,55,65,7,0,0
28/07/2013,CH de Colmar (Louis Pasteur),SAU Pasteur,0,25,129,154,22,11,0
28/07/2013,CH de Guebwiller,UHTCD,0,6,43,49,2,1,2
28/07/2013,CH de Mulhouse ( Hasenrain),PEDIATRIE NEONATOLOGIE,10,0,29,39,4,0,0
28/07/2013,CH de Mulhouse (Emile Muller-Moenschberg,URGENCES,2,13,120,135,9,8,4
28/07/2013,CH de Saverne,S.A.U. (ADULTES),0,5,51,56,7,7,0
28/07/2013,CH de Saverne,PEDIATRIE,2,0,14,16,1,0,0
28/07/2013,CH de Sélestat,Acceuil des urgences,1,9,102,112,16,5,1
28/07/2013,CH de Wissembourg,Urgences ,1,9,41,51,7,1,1
28/07/2013,Clinique des 3 Frontières,UPATOU (Structure des urgences),0,5,51,56,5,0,0
28/07/2013,Clinique Ste Odile (Strasbourg,UPATOU,1,3,79,83,2,3,0
28/07/2013,CMCO,GYNECO-OBSTETRIQUE,0,0,0,0,0,0,0
27/07/2013,CH Altkirch,Upatou,1,5,39,45,4,1,0
27/07/2013,CH de Colmar (CMC Le Parc),SAU Le Parc,11,0,29,40,0,5,0
27/07/2013,CH de Colmar (Louis Pasteur),SAU Pasteur,1,16,108,125,22,4,0
27/07/2013,CH de Guebwiller,UHTCD,1,4,55,60,2,1,1
27/07/2013,CH de Mulhouse ( Hasenrain),PEDIATRIE NEONATOLOGIE,9,0,24,33,4,0,0
27/07/2013,CH de Mulhouse (Emile Muller-Moenschberg,URGENCES,2,25,107,134,4,11,3
27/07/2013,CH de Saverne,PEDIATRIE,3,0,14,17,3,1,0
27/07/2013,CH de Saverne,S.A.U. (ADULTES),0,6,43,49,5,2,0
27/07/2013,CH de Sélestat,Acceuil des urgences,1,18,76,95,18,5,2
27/07/2013,CH de Thann,Urgences,0,13,35,48,3,2,1
27/07/2013,CH de Wissembourg,Urgences ,1,3,33,37,7,3,1
27/07/2013,CHU de Strasbourg(Hautepierre),Urgences Adulte HTP,0,19,61,80,6,15,0
27/07/2013,Clinique des 3 Frontières,UPATOU (Structure des urgences),1,2,40,43,4,0,1
27/07/2013,Clinique Ste Odile (Strasbourg,UPATOU,1,6,65,72,0,4,2
27/07/2013,CMCO,GYNECO-OBSTETRIQUE,0,0,0,0,0,0,0
26/07/2013,CH Altkirch,Upatou,0,9,28,37,5,1,1
26/07/2013,CH de Colmar (CMC Le Parc),SAU Le Parc,5,0,47,52,1,0,1
26/07/2013,CH de Colmar (Louis Pasteur),SAU Pasteur,0,19,109,128,26,8,4
26/07/2013,CH de Guebwiller,UHTCD,0,5,31,36,3,1,1
26/07/2013,CH de Mulhouse ( Hasenrain),PEDIATRIE NEONATOLOGIE,11,0,25,36,6,0,0
26/07/2013,CH de Mulhouse (Emile Muller-Moenschberg,URGENCES,2,35,96,133,13,0,0
26/07/2013,CH de Saverne,PEDIATRIE,2,0,24,26,2,0,0
26/07/2013,CH de Saverne,S.A.U. (ADULTES),0,14,34,48,10,5,3
26/07/2013,CH de Sélestat,Acceuil des urgences,1,7,72,80,14,2,3
26/07/2013,CH de Thann,Urgences,0,6,40,46,2,1,1
26/07/2013,CH de Wissembourg,Urgences ,0,10,30,40,8,0,0
26/07/2013,Clinique des 3 Frontières,UPATOU (Structure des urgences),0,5,41,46,4,0,0
26/07/2013,Clinique Ste Odile (Strasbourg,UPATOU,0,1,78,79,1,6,3
26/07/2013,CMCO,GYNECO-OBSTETRIQUE,0,0,0,0,0,0,0
25/07/2013,CH Altkirch,Upatou,0,3,30,33,3,2,0
25/07/2013,CH de Colmar (CMC Le Parc),SAU Le Parc,6,0,32,38,7,0,0
25/07/2013,CH de Colmar (Louis Pasteur),SAU Pasteur,0,20,114,134,20,13,2
25/07/2013,CH de Guebwiller,UHTCD,0,5,40,45,2,2,1
25/07/2013,CH de Mulhouse ( Hasenrain),PEDIATRIE NEONATOLOGIE,4,0,31,35,2,0,0
25/07/2013,CH de Mulhouse (Emile Muller-Moenschberg,URGENCES,1,15,127,143,13,0,5
25/07/2013,CH de Saverne,S.A.U. (ADULTES),0,12,46,58,10,4,1
25/07/2013,CH de Saverne,PEDIATRIE,2,0,11,13,2,0,0
25/07/2013,CH de Sélestat,Acceuil des urgences,1,6,68,75,16,6,1
25/07/2013,CH de Thann,Urgences,2,3,40,45,6,1,1
25/07/2013,CH de Wissembourg,Urgences ,1,9,30,40,6,0,0
25/07/2013,CHU de Strasbourg(Hautepierre),Urgences Adulte HTP,0,7,69,76,30,11,1
25/07/2013,Clinique des 3 Frontières,UPATOU (Structure des urgences),0,3,34,37,4,0,0
25/07/2013,Clinique Ste Odile (Strasbourg,UPATOU,0,4,55,59,0,4,2
25/07/2013,CMCO,GYNECO-OBSTETRIQUE,0,0,0,0,0,0,0
24/07/2013,CH Altkirch,Upatou,0,6,36,42,8,2,0
24/07/2013,CH de Colmar (CMC Le Parc),SAU Le Parc,7,0,35,42,6,0,0
24/07/2013,CH de Colmar (Louis Pasteur),SAU Pasteur,0,24,117,141,19,9,0
24/07/2013,CH de Guebwiller,UHTCD,0,6,39,45,3,1,0
24/07/2013,CH de Mulhouse ( Hasenrain),PEDIATRIE NEONATOLOGIE,9,0,34,43,3,1,0
24/07/2013,CH de Mulhouse (Emile Muller-Moenschberg,URGENCES,3,9,146,158,7,11,8
24/07/2013,CH de Saverne,S.A.U. (ADULTES),0,7,41,48,6,3,0
24/07/2013,CH de Saverne,PEDIATRIE,5,0,10,15,1,0,0
24/07/2013,CH de Thann,Urgences,0,7,51,58,2,1,0
24/07/2013,CH de Wissembourg,Urgences ,0,8,28,36,5,0,1
24/07/2013,CHU de Strasbourg(Hautepierre),Urgences Adulte HTP,0,13,73,86,17,10,7
24/07/2013,Clinique des 3 Frontières,UPATOU (Structure des urgences),0,10,45,55,11,0,1
24/07/2013,Clinique Ste Odile (Strasbourg,UPATOU,0,6,67,73,1,6,1
24/07/2013,CMCO,GYNECO-OBSTETRIQUE,0,0,0,0,0,0,0
23/07/2013,CH Altkirch,Upatou,0,6,37,43,9,2,1
23/07/2013,CH de Colmar (CMC Le Parc),SAU Le Parc,6,0,33,39,6,0,0
23/07/2013,CH de Colmar (Louis Pasteur),SAU Pasteur,0,24,100,124,18,11,1
23/07/2013,CH de Guebwiller,UHTCD,0,5,46,51,2,0,1
23/07/2013,CH de Mulhouse ( Hasenrain),PEDIATRIE NEONATOLOGIE,10,0,28,38,1,1,0
23/07/2013,CH de Mulhouse (Emile Muller-Moenschberg,URGENCES,1,24,97,122,13,9,0
23/07/2013,CH de Saverne,PEDIATRIE,1,0,8,9,2,0,0
23/07/2013,CH de Saverne,S.A.U. (ADULTES),0,8,29,37,5,4,0
23/07/2013,CH de Sélestat,Acceuil des urgences,2,8,73,83,13,2,2
23/07/2013,CH de Thann,Urgences,2,9,29,40,2,1,0
23/07/2013,CH de Wissembourg,Urgences ,0,4,27,31,5,0,3
23/07/2013,CHU de Strasbourg(Hautepierre),Urgences Adulte HTP,0,23,74,97,32,12,3
23/07/2013,Clinique des 3 Frontières,UPATOU (Structure des urgences),1,6,46,53,4,0,0
23/07/2013,Clinique Ste Odile (Strasbourg,UPATOU,0,0,63,63,1,8,2
23/07/2013,CMCO,GYNECO-OBSTETRIQUE,0,0,0,0,0,0,0
22/07/2013,CH Altkirch,Upatou,0,9,40,49,6,2,0
22/07/2013,CH de Colmar (CMC Le Parc),SAU Le Parc,3,0,33,36,6,0,0
22/07/2013,CH de Colmar (Louis Pasteur),SAU Pasteur,0,22,123,145,18,8,0
22/07/2013,CH de Guebwiller,UHTCD,0,6,55,61,2,1,1
22/07/2013,CH de Mulhouse ( Hasenrain),PEDIATRIE NEONATOLOGIE,9,0,20,29,2,2,0
22/07/2013,CH de Mulhouse (Emile Muller-Moenschberg,URGENCES,1,24,111,136,11,9,5
22/07/2013,CH de Saverne,PEDIATRIE,3,0,11,14,1,0,0
22/07/2013,CH de Saverne,S.A.U. (ADULTES),0,9,47,56,9,5,0
22/07/2013,CH de Sélestat,Acceuil des urgences,1,8,87,96,15,2,4
22/07/2013,CH de Thann,Urgences,1,4,46,51,5,1,1
22/07/2013,CH de Wissembourg,Urgences ,1,4,38,43,5,0,1
22/07/2013,CHU de Strasbourg(Hautepierre),Urgences Adulte HTP,0,16,74,90,12,11,0
22/07/2013,Clinique des 3 Frontières,UPATOU (Structure des urgences),0,5,38,43,4,0,2
22/07/2013,Clinique Ste Odile (Strasbourg,UPATOU,0,3,77,80,3,9,1
22/07/2013,CMCO,GYNECO-OBSTETRIQUE,0,0,0,0,0,0,0
21/07/2013,CH Altkirch,Upatou,0,8,41,49,5,2,1
21/07/2013,CH de Colmar (CMC Le Parc),SAU Le Parc,3,0,40,43,3,0,0
21/07/2013,CH de Colmar (Louis Pasteur),SAU Pasteur,0,28,111,139,24,12,0
21/07/2013,CH de Guebwiller,UHTCD,0,9,54,63,1,6,1
21/07/2013,CH de Mulhouse ( Hasenrain),PEDIATRIE NEONATOLOGIE,10,0,33,43,1,2,0
21/07/2013,CH de Mulhouse (Emile Muller-Moenschberg,URGENCES,2,22,102,126,17,12,5
21/07/2013,CH de Saverne,PEDIATRIE,3,0,13,16,1,1,0
21/07/2013,CH de Saverne,S.A.U. (ADULTES),0,5,50,55,8,2,0
21/07/2013,CH de Sélestat,Acceuil des urgences,4,7,104,115,14,9,2
21/07/2013,CH de Thann,Urgences,0,8,47,55,2,1,2
21/07/2013,Clinique des 3 Frontières,UPATOU (Structure des urgences),0,6,44,50,9,0,0
21/07/2013,Clinique Ste Odile (Strasbourg,UPATOU,0,3,77,80,2,6,1
21/07/2013,CMCO,GYNECO-OBSTETRIQUE,0,0,0,0,0,0,0
20/07/2013,CCOM,CCOM Chirurgie,0,1,21,22,2,0,0
20/07/2013,CH Altkirch,Upatou,1,3,33,37,7,2,1
20/07/2013,CH de Colmar (CMC Le Parc),SAU Le Parc,8,0,43,51,4,0,0
20/07/2013,CH de Colmar (Louis Pasteur),SAU Pasteur,0,28,122,150,26,12,2
20/07/2013,CH de Guebwiller,UHTCD,0,2,51,53,1,3,1
20/07/2013,CH de Mulhouse ( Hasenrain),PEDIATRIE NEONATOLOGIE,11,0,33,44,5,3,0
20/07/2013,CH de Mulhouse (Emile Muller-Moenschberg,URGENCES,2,25,123,150,16,9,2
20/07/2013,CH de Saverne,PEDIATRIE,3,0,15,18,0,0,0
20/07/2013,CH de Saverne,S.A.U. (ADULTES),0,11,51,62,9,3,0
20/07/2013,CH de Sélestat,Acceuil des urgences,1,10,90,101,18,3,4
20/07/2013,CH de Thann,Urgences,0,6,59,65,4,2,2
20/07/2013,CH de Wissembourg,Urgences ,0,3,32,35,3,1,2
20/07/2013,CHU de Strasbourg (Hôp. Civil),Urgences Médico-Chirurgicales NHC,0,14,85,99,37,4,0
20/07/2013,CHU de Strasbourg(Hautepierre),Urgences chirurgicales pédiatriques,7,0,40,47,2,2,0
20/07/2013,CHU de Strasbourg(Hautepierre),Gynéco-Obstétrique (HTP),0,0,28,28,10,0,0
20/07/2013,CHU de Strasbourg(Hautepierre),Urgences Adulte HTP,0,22,80,102,36,0,0
20/07/2013,CHU de Strasbourg(Hautepierre),Urgences chirurgicales pédiatriques,2,0,26,28,3,3,0
20/07/2013,Clinique des 3 Frontières,UPATOU (Structure des urgences),1,4,44,49,7,0,0
20/07/2013,Clinique Ste Odile (Strasbourg,UPATOU,0,7,80,87,1,1,5
20/07/2013,CMCO,GYNECO-OBSTETRIQUE,0,0,0,0,0,0,0
20/07/2013,SIHCUS/CMCO,GYNECOLOGIE ET OBSTETRIQUE - CMCO,0,0,0,0,0,0,0
19/07/2013,CCOM,CCOM Chirurgie,0,3,26,29,3,0,0
19/07/2013,CH Altkirch,Upatou,1,9,22,32,7,1,2
19/07/2013,CH de Colmar (CMC Le Parc),SAU Le Parc,6,0,49,55,8,0,0
19/07/2013,CH de Colmar (Louis Pasteur),SAU Pasteur,0,23,97,120,27,6,1
19/07/2013,CH de Guebwiller,UHTCD,0,3,34,37,2,3,0
19/07/2013,CH de Mulhouse ( Hasenrain),PEDIATRIE NEONATOLOGIE,9,0,15,24,4,3,0
19/07/2013,CH de Mulhouse (Emile Muller-Moenschberg,URGENCES,2,25,103,130,20,13,4
19/07/2013,CH de Saverne,S.A.U. (ADULTES),0,12,43,55,4,3,1
19/07/2013,CH de Saverne,PEDIATRIE,3,0,21,24,4,0,0
19/07/2013,CH de Sélestat,Acceuil des urgences,0,8,72,80,11,6,2
19/07/2013,CH de Thann,Urgences,0,6,44,50,2,2,0
19/07/2013,CH de Wissembourg,Urgences ,0,4,20,24,3,0,0
19/07/2013,CHU de Strasbourg (Hôp. Civil),Urgences Médico-Chirurgicales NHC,0,19,71,90,39,6,2
19/07/2013,CHU de Strasbourg(Hautepierre),Urgences Adulte HTP,0,20,86,106,46,0,0
19/07/2013,CHU de Strasbourg(Hautepierre),Urgences chirurgicales pédiatriques,4,0,53,57,4,4,0
19/07/2013,CHU de Strasbourg(Hautepierre),Urgences chirurgicales pédiatriques,7,0,30,37,8,8,0
19/07/2013,CHU de Strasbourg(Hautepierre),Gynéco-Obstétrique (HTP),0,0,26,26,8,0,0
19/07/2013,Clinique des 3 Frontières,UPATOU (Structure des urgences),1,8,38,47,5,0,2
19/07/2013,Clinique Ste Odile (Strasbourg,UPATOU,0,1,58,59,0,4,0
19/07/2013,CMCO,GYNECO-OBSTETRIQUE,0,0,0,0,0,0,0
19/07/2013,SIHCUS/CMCO,GYNECOLOGIE ET OBSTETRIQUE - CMCO,0,0,0,0,0,0,0
18/07/2013,CCOM,CCOM Chirurgie,0,1,28,29,2,0,0
18/07/2013,CH Altkirch,Upatou,0,3,29,32,5,1,1
18/07/2013,CH de Colmar (CMC Le Parc),SAU Le Parc,5,0,30,35,5,0,0
18/07/2013,CH de Colmar (Louis Pasteur),SAU Pasteur,0,16,100,116,13,10,0
18/07/2013,CH de Guebwiller,UHTCD,0,3,37,40,1,2,2
18/07/2013,CH de Mulhouse ( Hasenrain),PEDIATRIE NEONATOLOGIE,7,0,23,30,7,2,0
18/07/2013,CH de Mulhouse (Emile Muller-Moenschberg,URGENCES,1,16,107,124,16,11,2
18/07/2013,CH de Saverne,S.A.U. (ADULTES),0,12,49,61,12,5,3
18/07/2013,CH de Saverne,PEDIATRIE,2,0,11,13,1,0,0
18/07/2013,CH de Sélestat,Acceuil des urgences,4,12,70,86,16,10,2
18/07/2013,CH de Thann,Urgences,0,3,43,46,1,3,1
18/07/2013,CH de Wissembourg,Urgences ,0,11,51,62,12,1,0
18/07/2013,CHU de Strasbourg (Hôp. Civil),Urgences Médico-Chirurgicales NHC,0,18,60,78,42,6,2
18/07/2013,CHU de Strasbourg(Hautepierre),Urgences chirurgicales pédiatriques,15,0,29,44,5,5,0
18/07/2013,CHU de Strasbourg(Hautepierre),Gynéco-Obstétrique (HTP),0,0,32,32,13,0,0
18/07/2013,CHU de Strasbourg(Hautepierre),Urgences chirurgicales pédiatriques,4,0,39,43,5,4,0
18/07/2013,CHU de Strasbourg(Hautepierre),Urgences Adulte HTP,0,21,69,90,33,0,1
18/07/2013,Clinique des 3 Frontières,UPATOU (Structure des urgences),2,3,43,48,3,0,0
18/07/2013,Clinique Ste Odile (Strasbourg,UPATOU,1,2,70,73,1,11,5
18/07/2013,CMCO,GYNECO-OBSTETRIQUE,0,0,0,0,0,0,0
18/07/2013,SIHCUS/CMCO,GYNECOLOGIE ET OBSTETRIQUE - CMCO,0,0,0,0,0,0,0
17/07/2013,CCOM,CCOM Chirurgie,0,0,18,18,1,0,0
17/07/2013,CH Altkirch,Upatou,0,4,26,30,4,3,0
17/07/2013,CH de Colmar (CMC Le Parc),SAU Le Parc,5,0,32,37,2,0,0
17/07/2013,CH de Colmar (Louis Pasteur),SAU Pasteur,0,18,101,119,20,14,0
17/07/2013,CH de Guebwiller,UHTCD,1,3,52,56,1,5,0
17/07/2013,CH de Mulhouse ( Hasenrain),PEDIATRIE NEONATOLOGIE,12,0,16,28,4,1,1
17/07/2013,CH de Mulhouse (Emile Muller-Moenschberg,URGENCES,1,23,88,112,11,13,4
17/07/2013,CH de Saverne,PEDIATRIE,4,0,12,16,2,0,0
17/07/2013,CH de Saverne,S.A.U. (ADULTES),0,11,46,57,8,5,1
17/07/2013,CH de Thann,Urgences,2,6,36,44,0,0,1
17/07/2013,CH de Wissembourg,Urgences ,0,14,46,60,15,1,3
17/07/2013,CHU de Strasbourg (Hôp. Civil),Urgences Médico-Chirurgicales NHC,0,15,60,75,40,4,3
17/07/2013,CHU de Strasbourg(Hautepierre),Urgences chirurgicales pédiatriques,0,0,35,35,5,5,0
17/07/2013,CHU de Strasbourg(Hautepierre),Urgences Adulte HTP,0,19,77,96,32,0,1
17/07/2013,CHU de Strasbourg(Hautepierre),Urgences chirurgicales pédiatriques,12,0,22,34,5,5,0
17/07/2013,CHU de Strasbourg(Hautepierre),Gynéco-Obstétrique (HTP),1,0,26,27,12,0,0
17/07/2013,Clinique des 3 Frontières,UPATOU (Structure des urgences),0,4,47,51,3,0,1
17/07/2013,Clinique des Diaconesses,SOS Main,0,2,33,35,12,0,0
17/07/2013,Clinique Ste Odile (Strasbourg,UPATOU,0,2,50,52,2,3,1
17/07/2013,CMCO,GYNECO-OBSTETRIQUE,0,0,0,0,0,0,0
17/07/2013,SIHCUS/CMCO,GYNECOLOGIE ET OBSTETRIQUE - CMCO,0,0,0,0,0,0,0
16/07/2013,CCOM,CCOM Chirurgie,0,1,24,25,3,0,0
16/07/2013,CH Altkirch,Upatou,1,2,39,42,0,2,2
16/07/2013,CH de Colmar (CMC Le Parc),SAU Le Parc,8,0,45,53,14,0,0
16/07/2013,CH de Colmar (Louis Pasteur),SAU Pasteur,0,21,102,123,21,10,0
16/07/2013,CH de Guebwiller,UHTCD,0,3,45,48,2,2,4
16/07/2013,CH de Mulhouse ( Hasenrain),PEDIATRIE NEONATOLOGIE,5,0,21,26,1,2,0
16/07/2013,CH de Mulhouse (Emile Muller-Moenschberg,URGENCES,0,18,113,131,19,10,5
16/07/2013,CH de Saverne,S.A.U. (ADULTES),0,17,46,63,15,6,1
16/07/2013,CH de Saverne,PEDIATRIE,2,0,13,15,1,0,0
16/07/2013,CH de Sélestat,Acceuil des urgences,0,9,78,87,12,9,2
16/07/2013,CH de Thann,Urgences,0,10,42,52,2,2,5
16/07/2013,CH de Wissembourg,Urgences ,0,15,65,80,19,1,2
16/07/2013,CHU de Strasbourg (Hôp. Civil),Urgences Médico-Chirurgicales NHC,0,21,63,84,46,5,1
16/07/2013,CHU de Strasbourg(Hautepierre),Urgences Adulte HTP,0,15,80,95,27,0,0
16/07/2013,CHU de Strasbourg(Hautepierre),Urgences chirurgicales pédiatriques,2,0,31,33,5,5,0
16/07/2013,CHU de Strasbourg(Hautepierre),Urgences chirurgicales pédiatriques,12,0,39,51,6,7,0
16/07/2013,CHU de Strasbourg(Hautepierre),Gynéco-Obstétrique (HTP),0,0,22,22,8,0,0
16/07/2013,Clinique des 3 Frontières,UPATOU (Structure des urgences),1,6,39,46,10,0,1
16/07/2013,Clinique des Diaconesses,SOS Main,0,3,22,25,13,0,0
16/07/2013,Clinique Ste Odile (Strasbourg,UPATOU,0,4,74,78,0,7,0
16/07/2013,CMCO,GYNECO-OBSTETRIQUE,0,0,0,0,0,0,0
16/07/2013,SIHCUS/CMCO,GYNECOLOGIE ET OBSTETRIQUE - CMCO,0,0,0,0,0,0,0
15/07/2013,CCOM,CCOM Chirurgie,0,1,27,28,0,0,0
15/07/2013,CH Altkirch,Upatou,0,7,44,51,6,3,5
15/07/2013,CH de Colmar (CMC Le Parc),SAU Le Parc,8,0,38,46,9,1,1
15/07/2013,CH de Colmar (Louis Pasteur),SAU Pasteur,0,28,121,149,20,11,0
15/07/2013,CH de Guebwiller,UHTCD,1,8,51,60,2,1,4
15/07/2013,CH de Mulhouse ( Hasenrain),PEDIATRIE NEONATOLOGIE,7,0,29,36,4,3,0
15/07/2013,CH de Mulhouse (Emile Muller-Moenschberg,URGENCES,1,24,137,162,14,15,3
15/07/2013,CH de Saverne,S.A.U. (ADULTES),0,9,48,57,10,1,0
15/07/2013,CH de Saverne,PEDIATRIE,2,0,14,16,2,0,0
15/07/2013,CH de Sélestat,Acceuil des urgences,2,10,85,97,18,4,0
15/07/2013,CH de Thann,Urgences,0,10,50,60,6,2,2
15/07/2013,CH de Wissembourg,Urgences ,1,10,78,89,16,0,2
15/07/2013,CHU de Strasbourg (Hôp. Civil),Urgences Médico-Chirurgicales NHC,0,27,74,101,59,10,2
15/07/2013,CHU de Strasbourg(Hautepierre),Urgences chirurgicales pédiatriques,10,0,49,59,5,3,0
15/07/2013,CHU de Strasbourg(Hautepierre),Gynéco-Obstétrique (HTP),0,0,31,31,11,0,0
15/07/2013,CHU de Strasbourg(Hautepierre),Urgences Adulte HTP,0,16,106,122,34,0,1
15/07/2013,CHU de Strasbourg(Hautepierre),Urgences chirurgicales pédiatriques,2,0,52,54,5,5,0
15/07/2013,Clinique des 3 Frontières,UPATOU (Structure des urgences),0,8,42,50,4,0,1
15/07/2013,Clinique des Diaconesses,SOS Main,0,4,35,39,14,0,0
15/07/2013,Clinique Ste Odile (Strasbourg,UPATOU,1,9,74,84,1,5,2
15/07/2013,CMCO,GYNECO-OBSTETRIQUE,0,0,0,0,0,0,0
15/07/2013,SIHCUS/CMCO,GYNECOLOGIE ET OBSTETRIQUE - CMCO,0,0,0,0,0,0,0
14/07/2013,CCOM,CCOM Chirurgie,0,1,24,25,4,0,0
14/07/2013,CH Altkirch,Upatou,0,4,42,46,2,1,0
14/07/2013,CH de Colmar (CMC Le Parc),SAU Le Parc,6,0,59,65,9,0,1
14/07/2013,CH de Colmar (Louis Pasteur),SAU Pasteur,0,18,125,143,32,8,0
14/07/2013,CH de Guebwiller,UHTCD,1,9,55,65,1,0,4
14/07/2013,CH de Mulhouse ( Hasenrain),PEDIATRIE NEONATOLOGIE,11,0,39,50,3,0,0
14/07/2013,CH de Mulhouse (Emile Muller-Moenschberg,URGENCES,3,20,117,140,10,9,2
14/07/2013,CH de Saverne,S.A.U. (ADULTES),0,4,54,58,5,3,1
14/07/2013,CH de Saverne,PEDIATRIE,2,0,23,25,3,0,0
14/07/2013,CH de Sélestat,Acceuil des urgences,0,5,102,107,12,7,0
14/07/2013,CH de Thann,Urgences,0,3,53,56,1,0,1
14/07/2013,CHU de Strasbourg (Hôp. Civil),Urgences Médico-Chirurgicales NHC,0,16,85,101,36,3,0
14/07/2013,CHU de Strasbourg(Hautepierre),Urgences chirurgicales pédiatriques,2,0,37,39,4,3,0
14/07/2013,CHU de Strasbourg(Hautepierre),Urgences Adulte HTP,0,11,73,84,35,0,0
14/07/2013,CHU de Strasbourg(Hautepierre),Urgences chirurgicales pédiatriques,13,0,44,57,12,12,0
14/07/2013,CHU de Strasbourg(Hautepierre),Gynéco-Obstétrique (HTP),0,0,27,27,10,0,0
14/07/2013,Clinique des 3 Frontières,UPATOU (Structure des urgences),0,2,58,60,4,0,1
14/07/2013,Clinique Ste Odile (Strasbourg,UPATOU,1,1,86,88,0,4,2
14/07/2013,CMCO,GYNECO-OBSTETRIQUE,0,0,0,0,0,0,0
14/07/2013,SIHCUS/CMCO,GYNECOLOGIE ET OBSTETRIQUE - CMCO,0,0,0,0,0,0,0
13/07/2013,CCOM,CCOM Chirurgie,0,4,23,27,7,0,0
13/07/2013,CH Altkirch,Upatou,0,9,38,47,7,3,2
13/07/2013,CH de Colmar (CMC Le Parc),SAU Le Parc,11,0,4,15,9,0,0
13/07/2013,CH de Colmar (Louis Pasteur),SAU Pasteur,0,12,125,137,4,30,4
13/07/2013,CH de Guebwiller,UHTCD,0,2,46,48,1,2,6
13/07/2013,CH de Mulhouse ( Hasenrain),PEDIATRIE NEONATOLOGIE,12,0,26,38,2,3,0
13/07/2013,CH de Mulhouse (Emile Muller-Moenschberg,URGENCES,1,22,109,132,13,9,2
13/07/2013,CH de Saverne,S.A.U. (ADULTES),0,10,52,62,11,5,0
13/07/2013,CH de Saverne,PEDIATRIE,2,0,21,23,2,1,0
13/07/2013,CH de Sélestat,Acceuil des urgences,2,12,92,106,13,5,0
13/07/2013,CH de Thann,Urgences,1,5,49,55,3,0,4
13/07/2013,CHU de Strasbourg (Hôp. Civil),Urgences Médico-Chirurgicales NHC,0,12,90,102,27,2,2
13/07/2013,CHU de Strasbourg(Hautepierre),Urgences chirurgicales pédiatriques,11,0,43,54,5,5,0
13/07/2013,CHU de Strasbourg(Hautepierre),Gynéco-Obstétrique (HTP),0,0,32,32,13,0,0
13/07/2013,CHU de Strasbourg(Hautepierre),Urgences chirurgicales pédiatriques,2,0,53,55,6,6,0
13/07/2013,CHU de Strasbourg(Hautepierre),Urgences Adulte HTP,0,19,79,98,40,0,2
13/07/2013,Clinique des 3 Frontières,UPATOU (Structure des urgences),0,1,36,37,0,0,0
13/07/2013,Clinique Ste Odile (Strasbourg,UPATOU,1,5,75,81,1,6,4
13/07/2013,CMCO,GYNECO-OBSTETRIQUE,0,0,0,0,0,0,0
13/07/2013,SIHCUS/CMCO,GYNECOLOGIE ET OBSTETRIQUE - CMCO,0,0,0,0,0,0,0
12/07/2013,CCOM,CCOM Chirurgie,0,4,18,22,4,0,0
12/07/2013,CH Altkirch,Upatou,0,2,30,32,3,0,2
12/07/2013,CH de Colmar (CMC Le Parc),SAU Le Parc,15,0,35,50,9,0,0
12/07/2013,CH de Colmar (Louis Pasteur),SAU Pasteur,0,20,144,164,17,10,2
12/07/2013,CH de Guebwiller,UHTCD,0,3,50,53,0,2,7
12/07/2013,CH de Mulhouse ( Hasenrain),PEDIATRIE NEONATOLOGIE,1,0,36,37,7,2,1
12/07/2013,CH de Mulhouse (Emile Muller-Moenschberg,URGENCES,0,23,104,127,7,13,3
12/07/2013,CH de Saverne,S.A.U. (ADULTES),0,20,36,56,9,3,1
12/07/2013,CH de Saverne,PEDIATRIE,5,0,13,18,2,0,0
12/07/2013,CH de Sélestat,Acceuil des urgences,0,8,75,83,12,3,3
12/07/2013,CH de Thann,Urgences,0,5,40,45,5,1,2
12/07/2013,CHU de Strasbourg (Hôp. Civil),Urgences Médico-Chirurgicales NHC,0,9,76,85,49,8,2
12/07/2013,CHU de Strasbourg(Hautepierre),Urgences chirurgicales pédiatriques,13,0,36,49,7,7,0
12/07/2013,CHU de Strasbourg(Hautepierre),Gynéco-Obstétrique (HTP),0,0,23,23,11,0,0
12/07/2013,CHU de Strasbourg(Hautepierre),Urgences Adulte HTP,0,18,72,90,35,0,1
12/07/2013,CHU de Strasbourg(Hautepierre),Urgences chirurgicales pédiatriques,2,0,42,44,4,4,0
12/07/2013,Clinique des 3 Frontières,UPATOU (Structure des urgences),0,1,45,46,3,0,0
12/07/2013,Clinique Ste Odile (Strasbourg,UPATOU,1,5,63,69,3,6,2
12/07/2013,CMCO,GYNECO-OBSTETRIQUE,0,0,0,0,0,0,0
12/07/2013,SIHCUS/CMCO,GYNECOLOGIE ET OBSTETRIQUE - CMCO,0,0,0,0,0,0,0
11/07/2013,CCOM,CCOM Chirurgie,0,0,22,22,3,0,0
11/07/2013,CH Altkirch,Upatou,0,10,38,48,4,1,5
11/07/2013,CH de Colmar (CMC Le Parc),SAU Le Parc,3,0,29,32,3,0,0
11/07/2013,CH de Colmar (Louis Pasteur),SAU Pasteur,0,21,118,139,23,7,0
11/07/2013,CH de Guebwiller,UHTCD,0,5,47,52,0,2,3
11/07/2013,CH de Mulhouse ( Hasenrain),PEDIATRIE NEONATOLOGIE,11,0,39,50,5,4,0
11/07/2013,CH de Mulhouse (Emile Muller-Moenschberg,URGENCES,0,25,118,143,19,11,6
11/07/2013,CH de Saverne,S.A.U. (ADULTES),0,6,42,48,7,1,0
11/07/2013,CH de Saverne,PEDIATRIE,4,0,29,33,6,0,0
11/07/2013,CH de Thann,Urgences,1,6,39,46,1,0,1
11/07/2013,CH de Wissembourg,Urgences ,0,10,30,40,11,1,1
11/07/2013,CHU de Strasbourg (Hôp. Civil),Urgences Médico-Chirurgicales NHC,0,19,66,85,40,7,2
11/07/2013,CHU de Strasbourg(Hautepierre),Urgences chirurgicales pédiatriques,2,0,45,47,3,3,0
11/07/2013,CHU de Strasbourg(Hautepierre),Gynéco-Obstétrique (HTP),0,0,33,33,14,0,0
11/07/2013,CHU de Strasbourg(Hautepierre),Urgences Adulte HTP,0,18,89,107,39,0,1
11/07/2013,CHU de Strasbourg(Hautepierre),Urgences chirurgicales pédiatriques,2,0,38,40,1,1,0
11/07/2013,Clinique des 3 Frontières,UPATOU (Structure des urgences),0,4,36,40,1,0,0
11/07/2013,Clinique des Diaconesses,SOS Main,0,0,31,31,5,0,0
11/07/2013,Clinique Ste Odile (Strasbourg,UPATOU,0,6,62,68,1,3,1
11/07/2013,CMCO,GYNECO-OBSTETRIQUE,0,0,0,0,0,0,0
11/07/2013,SIHCUS/CMCO,GYNECOLOGIE ET OBSTETRIQUE - CMCO,0,0,0,0,0,0,0
10/07/2013,CCOM,CCOM Chirurgie,0,2,35,37,4,0,0
10/07/2013,CH Altkirch,Upatou,0,9,29,38,5,1,3
10/07/2013,CH de Colmar (CMC Le Parc),SAU Le Parc,7,0,46,53,8,0,0
10/07/2013,CH de Colmar (Louis Pasteur),SAU Pasteur,0,29,117,146,20,13,0
10/07/2013,CH de Guebwiller,UHTCD,0,4,49,53,2,1,0
10/07/2013,CH de Mulhouse ( Hasenrain),PEDIATRIE NEONATOLOGIE,8,0,25,33,5,3,0
10/07/2013,CH de Mulhouse (Emile Muller-Moenschberg,URGENCES,0,24,103,127,18,10,1
10/07/2013,CH de Saverne,S.A.U. (ADULTES),0,9,43,52,8,7,2
10/07/2013,CH de Saverne,PEDIATRIE,5,0,16,21,2,0,0
10/07/2013,CH de Sélestat,Acceuil des urgences,0,10,71,81,12,7,1
10/07/2013,CH de Thann,Urgences,0,3,38,41,3,0,2
10/07/2013,CH de Wissembourg,Urgences ,0,3,34,37,8,2,0
10/07/2013,CHU de Strasbourg (Hôp. Civil),Urgences Médico-Chirurgicales NHC,0,17,71,88,39,2,0
10/07/2013,CHU de Strasbourg(Hautepierre),Urgences chirurgicales pédiatriques,5,0,31,36,3,3,0
10/07/2013,CHU de Strasbourg(Hautepierre),Urgences chirurgicales pédiatriques,8,0,41,49,8,8,0
10/07/2013,CHU de Strasbourg(Hautepierre),Gynéco-Obstétrique (HTP),1,0,33,34,16,0,0
10/07/2013,CHU de Strasbourg(Hautepierre),Urgences Adulte HTP,0,16,83,99,36,0,1
10/07/2013,Clinique des 3 Frontières,UPATOU (Structure des urgences),0,7,39,46,6,0,2
10/07/2013,Clinique Ste Odile (Strasbourg,UPATOU,0,5,74,79,3,6,1
10/07/2013,CMCO,GYNECO-OBSTETRIQUE,0,0,0,0,0,0,0
10/07/2013,SIHCUS/CMCO,GYNECOLOGIE ET OBSTETRIQUE - CMCO,0,0,0,0,0,0,0
9/07/2013,CCOM,CCOM Chirurgie,0,1,24,25,4,0,0
9/07/2013,CH Altkirch,Upatou,0,4,38,42,6,2,2
9/07/2013,CH de Colmar (CMC Le Parc),SAU Le Parc,6,0,28,34,5,0,0
9/07/2013,CH de Colmar (Louis Pasteur),SAU Pasteur,0,20,101,121,16,10,0
9/07/2013,CH de Guebwiller,UHTCD,0,7,54,61,0,2,3
9/07/2013,CH de Mulhouse ( Hasenrain),PEDIATRIE NEONATOLOGIE,14,0,28,42,5,2,0
9/07/2013,CH de Mulhouse (Emile Muller-Moenschberg,URGENCES,0,21,120,141,8,16,6
9/07/2013,CH de Saverne,S.A.U. (ADULTES),0,8,42,50,7,3,1
9/07/2013,CH de Saverne,PEDIATRIE,1,0,18,19,3,1,0
9/07/2013,CH de Sélestat,Acceuil des urgences,1,16,63,80,16,4,1
9/07/2013,CH de Thann,Urgences,0,3,41,44,3,0,2
9/07/2013,CH de Wissembourg,Urgences ,1,7,40,48,8,2,3
9/07/2013,CHU de Strasbourg (Hôp. Civil),Urgences Médico-Chirurgicales NHC,0,25,62,87,44,0,1
9/07/2013,CHU de Strasbourg(Hautepierre),Urgences chirurgicales pédiatriques,10,0,35,45,8,8,0
9/07/2013,CHU de Strasbourg(Hautepierre),Gynéco-Obstétrique (HTP),1,0,29,30,16,0,0
9/07/2013,CHU de Strasbourg(Hautepierre),Urgences chirurgicales pédiatriques,4,0,52,56,3,3,0
9/07/2013,CHU de Strasbourg(Hautepierre),Urgences Adulte HTP,0,27,63,90,42,0,0
9/07/2013,Clinique des 3 Frontières,UPATOU (Structure des urgences),0,3,43,46,1,0,2
9/07/2013,Clinique Ste Odile (Strasbourg,UPATOU,0,4,71,75,4,9,0
9/07/2013,CMCO,GYNECO-OBSTETRIQUE,0,0,0,0,0,0,0
9/07/2013,SIHCUS/CMCO,GYNECOLOGIE ET OBSTETRIQUE - CMCO,0,0,0,0,0,0,0
8/07/2013,CCOM,CCOM Chirurgie,0,1,32,33,1,0,0
8/07/2013,CH Altkirch,Upatou,0,8,44,52,5,2,2
8/07/2013,CH de Colmar (CMC Le Parc),SAU Le Parc,5,0,35,40,4,0,0
8/07/2013,CH de Colmar (Louis Pasteur),SAU Pasteur,0,19,133,152,21,12,0
8/07/2013,CH de Guebwiller,UHTCD,0,3,49,52,2,2,3
8/07/2013,CH de Mulhouse ( Hasenrain),PEDIATRIE NEONATOLOGIE,8,0,34,42,5,3,0
8/07/2013,CH de Mulhouse (Emile Muller-Moenschberg,URGENCES,0,20,133,153,11,13,5
8/07/2013,CH de Saverne,S.A.U. (ADULTES),0,9,49,58,6,6,0
8/07/2013,CH de Saverne,PEDIATRIE,5,0,18,23,1,0,0
8/07/2013,CH de Sélestat,Acceuil des urgences,1,8,92,101,26,6,0
8/07/2013,CH de Thann,Urgences,0,10,39,49,2,0,2
8/07/2013,CH de Wissembourg,Urgences ,1,5,37,43,5,1,1
8/07/2013,CHU de Strasbourg (Hôp. Civil),Urgences Médico-Chirurgicales NHC,0,22,72,94,52,1,1
8/07/2013,CHU de Strasbourg(Hautepierre),Urgences Adulte HTP,0,25,100,125,48,0,3
8/07/2013,CHU de Strasbourg(Hautepierre),Urgences chirurgicales pédiatriques,14,0,38,52,5,6,0
8/07/2013,CHU de Strasbourg(Hautepierre),Gynéco-Obstétrique (HTP),0,0,25,25,9,0,0
8/07/2013,CHU de Strasbourg(Hautepierre),Urgences chirurgicales pédiatriques,0,0,37,37,3,3,0
8/07/2013,Clinique des 3 Frontières,UPATOU (Structure des urgences),2,5,49,56,5,0,0
8/07/2013,Clinique Ste Odile (Strasbourg,UPATOU,0,7,71,78,1,8,1
8/07/2013,CMCO,GYNECO-OBSTETRIQUE,0,0,0,0,0,0,0
8/07/2013,SIHCUS/CMCO,GYNECOLOGIE ET OBSTETRIQUE - CMCO,0,0,0,0,0,0,0
7/07/2013,CCOM,CCOM Chirurgie,0,1,15,16,2,0,0
7/07/2013,CH Altkirch,Upatou,0,1,43,44,5,0,3
7/07/2013,CH de Colmar (CMC Le Parc),SAU Le Parc,6,0,50,56,7,0,0
7/07/2013,CH de Colmar (Louis Pasteur),SAU Pasteur,0,24,117,141,21,6,0
7/07/2013,CH de Guebwiller,UHTCD,0,3,56,59,1,4,2
7/07/2013,CH de Mulhouse ( Hasenrain),PEDIATRIE NEONATOLOGIE,13,0,31,44,6,1,0
7/07/2013,CH de Mulhouse (Emile Muller-Moenschberg,URGENCES,1,17,141,159,20,8,6
7/07/2013,CH de Saverne,PEDIATRIE,8,0,23,31,2,1,0
7/07/2013,CH de Saverne,S.A.U. (ADULTES),0,7,56,63,11,5,1
7/07/2013,CH de Sélestat,Acceuil des urgences,2,9,101,112,14,7,1
7/07/2013,CH de Thann,Urgences,0,4,52,56,1,1,8
7/07/2013,CH de Wissembourg,Urgences ,0,2,53,55,6,0,2
7/07/2013,CHU de Strasbourg (Hôp. Civil),Urgences Médico-Chirurgicales NHC,0,18,82,100,31,1,2
7/07/2013,CHU de Strasbourg(Hautepierre),Urgences chirurgicales pédiatriques,13,0,52,65,4,5,0
7/07/2013,CHU de Strasbourg(Hautepierre),Gynéco-Obstétrique (HTP),0,0,27,27,12,0,0
7/07/2013,CHU de Strasbourg(Hautepierre),Urgences chirurgicales pédiatriques,3,0,44,47,6,6,0
7/07/2013,CHU de Strasbourg(Hautepierre),Urgences Adulte HTP,0,14,98,112,33,0,1
7/07/2013,Clinique des 3 Frontières,UPATOU (Structure des urgences),0,4,44,48,4,0,1
7/07/2013,Clinique Ste Odile (Strasbourg,UPATOU,0,5,88,93,1,8,6
7/07/2013,CMCO,GYNECO-OBSTETRIQUE,0,0,0,0,0,0,0
7/07/2013,SIHCUS/CMCO,GYNECOLOGIE ET OBSTETRIQUE - CMCO,0,0,0,0,0,0,0
6/07/2013,CCOM,CCOM Chirurgie,0,2,20,22,1,0,0
6/07/2013,CH Altkirch,Upatou,0,9,38,47,9,2,3
6/07/2013,CH de Colmar (CMC Le Parc),SAU Le Parc,9,0,35,44,5,0,0
6/07/2013,CH de Colmar (Louis Pasteur),SAU Pasteur,0,12,122,134,24,5,4
6/07/2013,CH de Guebwiller,UHTCD,0,7,58,65,2,2,10
6/07/2013,CH de Mulhouse ( Hasenrain),PEDIATRIE NEONATOLOGIE,10,0,30,40,4,1,0
6/07/2013,CH de Mulhouse (Emile Muller-Moenschberg,URGENCES,0,23,126,149,9,17,3
6/07/2013,CH de Saverne,S.A.U. (ADULTES),0,12,42,54,13,5,2
6/07/2013,CH de Saverne,PEDIATRIE,4,0,20,24,3,0,0
6/07/2013,CH de Sélestat,Acceuil des urgences,0,21,60,81,15,4,1
6/07/2013,CH de Thann,Urgences,0,4,52,56,1,0,2
6/07/2013,CH de Wissembourg,Urgences ,0,7,41,48,5,0,2
6/07/2013,CHU de Strasbourg (Hôp. Civil),Urgences Médico-Chirurgicales NHC,0,18,85,103,42,15,0
6/07/2013,CHU de Strasbourg(Hautepierre),Urgences chirurgicales pédiatriques,14,0,39,53,5,7,0
6/07/2013,CHU de Strasbourg(Hautepierre),Gynéco-Obstétrique (HTP),0,0,26,26,15,0,0
6/07/2013,CHU de Strasbourg(Hautepierre),Urgences chirurgicales pédiatriques,3,0,48,51,4,4,0
6/07/2013,CHU de Strasbourg(Hautepierre),Urgences Adulte HTP,0,22,109,131,29,0,0
6/07/2013,Clinique des 3 Frontières,UPATOU (Structure des urgences),1,11,49,61,8,1,2
6/07/2013,Clinique Ste Odile (Strasbourg,UPATOU,0,2,89,91,3,12,1
6/07/2013,CMCO,GYNECO-OBSTETRIQUE,0,0,0,0,0,0,0
6/07/2013,SIHCUS/CMCO,GYNECOLOGIE ET OBSTETRIQUE - CMCO,0,0,2,2,1,0,0
5/07/2013,CCOM,CCOM Chirurgie,0,2,21,23,1,0,0
5/07/2013,CH Altkirch,Upatou,0,4,36,40,3,2,0
5/07/2013,CH de Colmar (CMC Le Parc),SAU Le Parc,1,0,32,33,7,0,0
5/07/2013,CH de Colmar (Louis Pasteur),SAU Pasteur,1,20,107,128,22,6,6
5/07/2013,CH de Guebwiller,UHTCD,0,4,55,59,2,1,4
5/07/2013,CH de Mulhouse ( Hasenrain),PEDIATRIE NEONATOLOGIE,8,0,30,38,8,1,0
5/07/2013,CH de Mulhouse (Emile Muller-Moenschberg,URGENCES,0,19,96,115,13,7,3
5/07/2013,CH de Saverne,S.A.U. (ADULTES),0,17,47,64,10,3,0
5/07/2013,CH de Saverne,PEDIATRIE,3,0,21,24,3,2,0
5/07/2013,CH de Sélestat,Acceuil des urgences,5,13,71,89,15,1,6
5/07/2013,CH de Thann,Urgences,2,6,31,39,1,3,4
5/07/2013,CH de Wissembourg,Urgences ,0,5,24,29,5,0,0
5/07/2013,CHU de Strasbourg (Hôp. Civil),Urgences Médico-Chirurgicales NHC,0,18,65,83,45,11,0
5/07/2013,CHU de Strasbourg(Hautepierre),Urgences chirurgicales pédiatriques,7,0,31,38,7,7,0
5/07/2013,CHU de Strasbourg(Hautepierre),Gynéco-Obstétrique (HTP),0,0,24,24,12,0,0
5/07/2013,CHU de Strasbourg(Hautepierre),Urgences Adulte HTP,0,21,90,111,48,0,1
5/07/2013,CHU de Strasbourg(Hautepierre),Urgences chirurgicales pédiatriques,4,0,34,38,2,3,0
5/07/2013,Clinique des 3 Frontières,UPATOU (Structure des urgences),0,3,34,37,3,0,1
5/07/2013,Clinique des Diaconesses,SOS Main,0,5,34,39,0,0,0
5/07/2013,Clinique Ste Odile (Strasbourg,UPATOU,1,4,69,74,2,6,0
5/07/2013,CMCO,GYNECO-OBSTETRIQUE,0,0,0,0,0,0,0
5/07/2013,SIHCUS/CMCO,GYNECOLOGIE ET OBSTETRIQUE - CMCO,0,0,41,41,0,0,0
4/07/2013,CCOM,CCOM Chirurgie,0,0,15,15,0,0,0
4/07/2013,CH Altkirch,Upatou,0,4,37,41,4,1,2
4/07/2013,CH de Colmar (CMC Le Parc),SAU Le Parc,7,0,36,43,6,0,0
4/07/2013,CH de Colmar (Louis Pasteur),SAU Pasteur,0,20,101,121,15,11,1
4/07/2013,CH de Guebwiller,UHTCD,0,3,50,53,1,1,6
4/07/2013,CH de Mulhouse ( Hasenrain),PEDIATRIE NEONATOLOGIE,5,0,36,41,6,2,0
4/07/2013,CH de Mulhouse (Emile Muller-Moenschberg,URGENCES,0,16,101,117,9,9,3
4/07/2013,CH de Saverne,S.A.U. (ADULTES),0,12,46,58,10,6,2
4/07/2013,CH de Saverne,PEDIATRIE,3,0,11,14,2,0,0
4/07/2013,CH de Thann,Urgences,1,3,26,30,4,0,1
4/07/2013,CH de Wissembourg,Urgences ,0,4,33,37,4,0,2
4/07/2013,CHU de Strasbourg (Hôp. Civil),Urgences Médico-Chirurgicales NHC,0,19,56,75,42,3,0
4/07/2013,CHU de Strasbourg(Hautepierre),Urgences chirurgicales pédiatriques,7,0,36,43,4,4,0
4/07/2013,CHU de Strasbourg(Hautepierre),Gynéco-Obstétrique (HTP),0,0,32,32,14,0,0
4/07/2013,CHU de Strasbourg(Hautepierre),Urgences chirurgicales pédiatriques,3,0,58,61,4,3,0
4/07/2013,CHU de Strasbourg(Hautepierre),Urgences Adulte HTP,0,17,82,99,42,0,1
4/07/2013,Clinique des 3 Frontières,UPATOU (Structure des urgences),0,5,43,48,4,0,2
4/07/2013,Clinique des Diaconesses,SOS Main,0,1,37,38,1,0,0
4/07/2013,Clinique Ste Odile (Strasbourg,UPATOU,0,1,67,68,0,4,1
4/07/2013,CMCO,GYNECO-OBSTETRIQUE,0,0,0,0,0,0,0
4/07/2013,SIHCUS/CMCO,GYNECOLOGIE ET OBSTETRIQUE - CMCO,0,0,0,0,0,0,0
3/07/2013,CCOM,CCOM Chirurgie,0,3,32,35,1,0,0
3/07/2013,CH Altkirch,Upatou,0,7,22,29,3,0,0
3/07/2013,CH de Colmar (CMC Le Parc),SAU Le Parc,3,0,34,37,11,0,0
3/07/2013,CH de Colmar (Louis Pasteur),SAU Pasteur,0,23,109,132,17,13,2
3/07/2013,CH de Guebwiller,UHTCD,0,6,24,30,3,3,0
3/07/2013,CH de Mulhouse ( Hasenrain),PEDIATRIE NEONATOLOGIE,11,0,22,33,1,1,1
3/07/2013,CH de Mulhouse (Emile Muller-Moenschberg,URGENCES,0,22,94,116,6,15,5
3/07/2013,CH de Saverne,PEDIATRIE,1,0,21,22,4,0,0
3/07/2013,CH de Saverne,S.A.U. (ADULTES),0,11,35,46,5,4,0
3/07/2013,CH de Sélestat,Acceuil des urgences,0,7,66,73,12,4,2
3/07/2013,CH de Thann,Urgences,0,6,39,45,6,0,2
3/07/2013,CH de Wissembourg,Urgences ,0,5,29,34,5,0,1
3/07/2013,CHU de Strasbourg (Hôp. Civil),Urgences Médico-Chirurgicales NHC,0,13,66,79,34,5,1
3/07/2013,CHU de Strasbourg(Hautepierre),Urgences chirurgicales pédiatriques,8,0,30,38,6,5,0
3/07/2013,CHU de Strasbourg(Hautepierre),Gynéco-Obstétrique (HTP),1,0,29,30,12,0,0
3/07/2013,CHU de Strasbourg(Hautepierre),Urgences Adulte HTP,0,15,66,81,28,0,0
3/07/2013,CHU de Strasbourg(Hautepierre),Urgences chirurgicales pédiatriques,2,0,35,37,6,6,0
3/07/2013,Clinique des 3 Frontières,UPATOU (Structure des urgences),0,2,36,38,3,0,0
3/07/2013,Clinique Ste Odile (Strasbourg,UPATOU,0,2,62,64,3,10,0
3/07/2013,CMCO,GYNECO-OBSTETRIQUE,0,0,0,0,0,0,0
3/07/2013,SIHCUS/CMCO,GYNECOLOGIE ET OBSTETRIQUE - CMCO,0,0,0,0,0,0,0
2/07/2013,CCOM,CCOM Chirurgie,0,3,27,30,2,0,0
2/07/2013,CH Altkirch,Upatou,0,3,34,37,5,0,1
2/07/2013,CH de Colmar (CMC Le Parc),SAU Le Parc,5,0,29,34,8,0,0
2/07/2013,CH de Colmar (Louis Pasteur),SAU Pasteur,0,28,102,130,25,12,0
2/07/2013,CH de Guebwiller,UHTCD,1,3,35,39,1,1,1
2/07/2013,CH de Mulhouse ( Hasenrain),PEDIATRIE NEONATOLOGIE,7,0,20,27,2,1,0
2/07/2013,CH de Mulhouse (Emile Muller-Moenschberg,URGENCES,0,21,97,118,13,11,4
2/07/2013,CH de Saverne,PEDIATRIE,3,0,18,21,4,1,0
2/07/2013,CH de Saverne,S.A.U. (ADULTES),0,8,37,45,8,3,1
2/07/2013,CH de Sélestat,Acceuil des urgences,2,13,67,82,13,7,1
2/07/2013,CH de Thann,Urgences,0,6,50,56,4,0,4
2/07/2013,CH de Wissembourg,Urgences ,0,4,24,28,6,0,0
2/07/2013,CHU de Strasbourg (Hôp. Civil),Urgences Médico-Chirurgicales NHC,0,21,53,74,40,3,3
2/07/2013,CHU de Strasbourg(Hautepierre),Urgences chirurgicales pédiatriques,2,0,51,53,6,6,0
2/07/2013,CHU de Strasbourg(Hautepierre),Urgences chirurgicales pédiatriques,10,0,28,38,7,6,0
2/07/2013,CHU de Strasbourg(Hautepierre),Gynéco-Obstétrique (HTP),1,0,24,25,14,0,0
2/07/2013,CHU de Strasbourg(Hautepierre),Urgences Adulte HTP,0,15,90,105,26,0,0
2/07/2013,Clinique des 3 Frontières,UPATOU (Structure des urgences),0,6,37,43,1,0,0
2/07/2013,Clinique Ste Odile (Strasbourg,UPATOU,0,1,69,70,2,4,1
2/07/2013,CMCO,GYNECO-OBSTETRIQUE,0,0,0,0,0,0,0
2/07/2013,SIHCUS/CMCO,GYNECOLOGIE ET OBSTETRIQUE - CMCO,0,0,0,0,0,0,0
1/07/2013,CCOM,CCOM Chirurgie,0,2,30,32,0,0,0
1/07/2013,CH Altkirch,Upatou,0,8,35,43,4,2,3
1/07/2013,CH de Colmar (CMC Le Parc),SAU Le Parc,4,0,49,53,6,0,0
1/07/2013,CH de Colmar (Louis Pasteur),SAU Pasteur,0,26,123,149,28,10,0
1/07/2013,CH de Guebwiller,UHTCD,1,2,40,43,1,1,0
1/07/2013,CH de Mulhouse ( Hasenrain),PEDIATRIE NEONATOLOGIE,7,0,31,38,4,1,0
1/07/2013,CH de Mulhouse (Emile Muller-Moenschberg,URGENCES,0,20,105,125,16,10,4
1/07/2013,CH de Saverne,S.A.U. (ADULTES),0,12,48,60,13,4,0
1/07/2013,CH de Saverne,PEDIATRIE,6,0,13,19,4,0,0
1/07/2013,CH de Sélestat,Acceuil des urgences,0,14,73,87,10,5,3
1/07/2013,CH de Thann,Urgences,1,4,44,49,3,1,3
1/07/2013,CH de Wissembourg,Urgences ,0,5,35,40,6,0,2
1/07/2013,CHU de Strasbourg (Hôp. Civil),Urgences Médico-Chirurgicales NHC,0,16,64,80,46,7,2
1/07/2013,CHU de Strasbourg(Hautepierre),Urgences chirurgicales pédiatriques,1,0,55,56,8,6,0
1/07/2013,CHU de Strasbourg(Hautepierre),Urgences Adulte HTP,0,19,79,98,44,0,1
1/07/2013,CHU de Strasbourg(Hautepierre),Urgences chirurgicales pédiatriques,10,0,31,41,6,5,0
1/07/2013,CHU de Strasbourg(Hautepierre),Gynéco-Obstétrique (HTP),0,0,40,40,12,0,0
1/07/2013,Clinique des 3 Frontières,UPATOU (Structure des urgences),0,7,46,53,3,1,0
1/07/2013,Clinique Ste Odile (Strasbourg,UPATOU,0,4,63,67,1,7,0
1/07/2013,CMCO,GYNECO-OBSTETRIQUE,0,0,0,0,0,0,0
1/07/2013,SIHCUS/CMCO,GYNECOLOGIE ET OBSTETRIQUE - CMCO,0,0,0,0,0,0,0
31/10/2013,CCOM,CCOM Chirurgie,0,0,29,29,2,0,0
31/10/2013,CH Altkirch,Upatou,0,3,32,35,6,0,1
31/10/2013,CH de Colmar (CMC Le Parc),SAU Le Parc,3,0,22,25,5,0,0
31/10/2013,CH de Colmar (Louis Pasteur),SAU Pasteur,0,19,98,117,23,10,1
31/10/2013,CH de Guebwiller,UHTCD,1,5,33,39,1,4,0
31/10/2013,CH de Mulhouse ( Hasenrain),PEDIATRIE NEONATOLOGIE,7,0,19,26,2,0,0
31/10/2013,CH de Mulhouse (Emile Muller-Moenschberg,URGENCES,2,26,90,118,14,12,2
31/10/2013,CH de Saverne,PEDIATRIE,1,0,17,18,2,0,0
31/10/2013,CH de Saverne,S.A.U. (ADULTES),0,7,29,36,3,2,1
31/10/2013,CH de Thann,Urgences,1,2,32,35,3,0,2
31/10/2013,CH de Wissembourg,Urgences ,1,5,32,38,5,0,1
31/10/2013,CHU de Strasbourg (Hôp. Civil),Urgences Médico-Chirurgicales NHC,0,19,70,89,42,7,2
31/10/2013,CHU de Strasbourg(Hautepierre),Urgences chirurgicales pédiatriques,12,0,34,46,5,5,0
31/10/2013,CHU de Strasbourg(Hautepierre),Gynéco-Obstétrique (HTP),1,0,22,23,8,0,0
31/10/2013,CHU de Strasbourg(Hautepierre),Urgences chirurgicales pédiatriques,2,0,35,37,3,2,0
31/10/2013,CHU de Strasbourg(Hautepierre),Urgences Adulte HTP,0,14,65,79,23,0,1
31/10/2013,Clinique des 3 Frontières,UPATOU (Structure des urgences),0,5,28,33,3,0,1
31/10/2013,Clinique Ste Odile (Strasbourg,UPATOU,0,6,60,66,2,8,0
31/10/2013,CMCO,GYNECO-OBSTETRIQUE,0,0,0,0,0,0,0
31/10/2013,SIHCUS/CMCO,GYNECOLOGIE ET OBSTETRIQUE - CMCO,0,0,0,0,0,0,0
30/10/2013,CCOM,CCOM Chirurgie,0,4,32,36,6,0,0
30/10/2013,CH Altkirch,Upatou,0,6,22,28,7,0,1
30/10/2013,CH de Colmar (CMC Le Parc),SAU Le Parc,9,0,29,38,3,0,0
30/10/2013,CH de Colmar (Louis Pasteur),SAU Pasteur,0,29,107,136,29,9,0
30/10/2013,CH de Guebwiller,UHTCD,0,6,36,42,4,1,1
30/10/2013,CH de Mulhouse ( Hasenrain),PEDIATRIE NEONATOLOGIE,14,0,22,36,4,0,1
30/10/2013,CH de Mulhouse (Emile Muller-Moenschberg,URGENCES,1,18,103,122,10,15,3
30/10/2013,CH de Saverne,PEDIATRIE,4,0,17,21,1,0,0
30/10/2013,CH de Saverne,S.A.U. (ADULTES),0,14,39,53,13,3,2
30/10/2013,CH de Thann,Urgences,0,6,33,39,1,2,2
30/10/2013,CH de Wissembourg,Urgences ,0,5,21,26,7,1,1
30/10/2013,CHU de Strasbourg (Hôp. Civil),Urgences Médico-Chirurgicales NHC,0,15,66,81,49,6,1
30/10/2013,CHU de Strasbourg(Hautepierre),Urgences chirurgicales pédiatriques,15,0,38,53,7,5,0
30/10/2013,CHU de Strasbourg(Hautepierre),Gynéco-Obstétrique (HTP),0,0,17,17,4,0,0
30/10/2013,CHU de Strasbourg(Hautepierre),Urgences Adulte HTP,0,22,58,80,27,0,0
30/10/2013,CHU de Strasbourg(Hautepierre),Urgences chirurgicales pédiatriques,2,0,45,47,4,4,0
30/10/2013,Clinique des 3 Frontières,UPATOU (Structure des urgences),1,4,39,44,2,0,1
30/10/2013,Clinique des Diaconesses,SOS Main,0,1,32,33,12,0,2
30/10/2013,Clinique Ste Odile (Strasbourg,UPATOU,0,3,50,53,3,5,0
30/10/2013,CMCO,GYNECO-OBSTETRIQUE,0,0,0,0,0,0,0
30/10/2013,SIHCUS/CMCO,GYNECOLOGIE ET OBSTETRIQUE - CMCO,0,0,0,0,0,0,0
29/10/2013,CCOM,CCOM Chirurgie,0,1,29,30,4,0,0
29/10/2013,CH Altkirch,Upatou,0,9,32,41,4,3,2
29/10/2013,CH de Colmar (CMC Le Parc),SAU Le Parc,12,0,25,37,3,0,0
29/10/2013,CH de Colmar (Louis Pasteur),SAU Pasteur,0,19,93,112,25,11,0
29/10/2013,CH de Guebwiller,UHTCD,1,3,32,36,4,0,1
29/10/2013,CH de Mulhouse ( Hasenrain),PEDIATRIE NEONATOLOGIE,8,0,25,33,5,4,0
29/10/2013,CH de Mulhouse (Emile Muller-Moenschberg,URGENCES,1,16,111,128,7,18,3
29/10/2013,CH de Saverne,PEDIATRIE,0,0,10,10,2,1,0
29/10/2013,CH de Saverne,S.A.U. (ADULTES),0,23,42,65,20,6,0
29/10/2013,CH de Thann,Urgences,0,7,19,26,4,2,3
29/10/2013,CH de Wissembourg,Urgences ,1,4,29,34,6,2,0
29/10/2013,CHU de Strasbourg (Hôp. Civil),Urgences Médico-Chirurgicales NHC,0,16,62,78,48,9,2
29/10/2013,CHU de Strasbourg(Hautepierre),Urgences chirurgicales pédiatriques,1,0,39,40,6,6,0
29/10/2013,CHU de Strasbourg(Hautepierre),Urgences Adulte HTP,0,15,78,93,38,1,0
29/10/2013,CHU de Strasbourg(Hautepierre),Urgences chirurgicales pédiatriques,20,0,30,50,10,9,0
29/10/2013,CHU de Strasbourg(Hautepierre),Gynéco-Obstétrique (HTP),1,0,21,22,12,0,0
29/10/2013,Clinique des 3 Frontières,UPATOU (Structure des urgences),0,7,28,35,5,0,0
29/10/2013,Clinique des Diaconesses,SOS Main,1,1,28,30,9,0,0
29/10/2013,Clinique Ste Odile (Strasbourg,UPATOU,0,3,65,68,4,6,3
29/10/2013,CMCO,GYNECO-OBSTETRIQUE,0,0,0,0,0,0,0
29/10/2013,SIHCUS/CMCO,GYNECOLOGIE ET OBSTETRIQUE - CMCO,0,0,0,0,0,0,0
28/10/2013,CCOM,CCOM Chirurgie,0,0,39,39,2,0,0
28/10/2013,CH Altkirch,Upatou,0,6,35,41,3,1,2
28/10/2013,CH de Colmar (CMC Le Parc),SAU Le Parc,4,0,30,34,5,0,0
28/10/2013,CH de Colmar (Louis Pasteur),SAU Pasteur,0,30,108,138,23,13,0
28/10/2013,CH de Guebwiller,UHTCD,0,1,34,35,1,2,1
28/10/2013,CH de Mulhouse ( Hasenrain),PEDIATRIE NEONATOLOGIE,12,0,28,40,4,2,1
28/10/2013,CH de Mulhouse (Emile Muller-Moenschberg,URGENCES,2,27,132,161,29,6,4
28/10/2013,CH de Saverne,S.A.U. (ADULTES),0,12,40,52,17,6,0
28/10/2013,CH de Saverne,PEDIATRIE,4,0,13,17,2,1,0
28/10/2013,CH de Thann,Urgences,1,5,30,36,3,2,1
28/10/2013,CH de Wissembourg,Urgences ,0,8,26,34,8,0,1
28/10/2013,CHU de Strasbourg (Hôp. Civil),Urgences Médico-Chirurgicales NHC,0,17,63,80,46,7,2
28/10/2013,CHU de Strasbourg(Hautepierre),Urgences chirurgicales pédiatriques,16,0,29,45,8,8,0
28/10/2013,CHU de Strasbourg(Hautepierre),Gynéco-Obstétrique (HTP),0,0,28,28,16,0,0
28/10/2013,CHU de Strasbourg(Hautepierre),Urgences chirurgicales pédiatriques,2,0,28,30,2,2,0
28/10/2013,CHU de Strasbourg(Hautepierre),Urgences Adulte HTP,0,20,71,91,27,0,1
28/10/2013,Clinique des 3 Frontières,UPATOU (Structure des urgences),0,5,40,45,9,0,0
28/10/2013,Clinique Ste Odile (Strasbourg,UPATOU,0,5,71,76,1,7,1
28/10/2013,CMCO,GYNECO-OBSTETRIQUE,0,0,0,0,0,0,0
28/10/2013,SIHCUS/CMCO,GYNECOLOGIE ET OBSTETRIQUE - CMCO,0,0,0,0,0,0,0
27/10/2013,CCOM,CCOM Chirurgie,0,4,14,18,4,0,0
27/10/2013,CH Altkirch,Upatou,0,1,48,49,2,0,1
27/10/2013,CH de Colmar (CMC Le Parc),SAU Le Parc,11,0,46,57,9,0,0
27/10/2013,CH de Colmar (Louis Pasteur),SAU Pasteur,0,14,103,117,18,8,0
27/10/2013,CH de Guebwiller,UHTCD,0,3,48,51,0,4,1
27/10/2013,CH de Mulhouse ( Hasenrain),PEDIATRIE NEONATOLOGIE,19,0,37,56,7,2,0
27/10/2013,CH de Mulhouse (Emile Muller-Moenschberg,URGENCES,2,16,148,166,14,12,1
27/10/2013,CH de Saverne,PEDIATRIE,3,0,18,21,7,0,0
27/10/2013,CH de Saverne,S.A.U. (ADULTES),0,4,25,29,4,1,0
27/10/2013,CH de Thann,Urgences,2,2,38,42,0,1,1
27/10/2013,CH de Wissembourg,Urgences ,1,3,33,37,6,2,0
27/10/2013,CHU de Strasbourg (Hôp. Civil),Urgences Médico-Chirurgicales NHC,0,10,80,90,31,1,4
27/10/2013,CHU de Strasbourg(Hautepierre),Urgences chirurgicales pédiatriques,13,0,40,53,2,2,0
27/10/2013,CHU de Strasbourg(Hautepierre),Gynéco-Obstétrique (HTP),1,0,32,33,11,0,0
27/10/2013,CHU de Strasbourg(Hautepierre),Urgences Adulte HTP,0,22,84,106,24,0,0
27/10/2013,CHU de Strasbourg(Hautepierre),Urgences chirurgicales pédiatriques,2,0,32,34,0,0,0
27/10/2013,Clinique des 3 Frontières,UPATOU (Structure des urgences),1,2,44,47,3,0,1
27/10/2013,Clinique des Diaconesses,SOS Main,0,2,24,26,0,0,0
27/10/2013,Clinique Ste Odile (Strasbourg,UPATOU,0,4,62,66,1,5,0
27/10/2013,CMCO,GYNECO-OBSTETRIQUE,0,0,0,0,0,0,0
27/10/2013,SIHCUS/CMCO,GYNECOLOGIE ET OBSTETRIQUE - CMCO,0,0,0,0,0,0,0
26/10/2013,CCOM,CCOM Chirurgie,0,0,18,18,2,0,0
26/10/2013,CH Altkirch,Upatou,0,5,40,45,7,1,0
26/10/2013,CH de Colmar (CMC Le Parc),SAU Le Parc,8,0,30,38,7,0,1
26/10/2013,CH de Colmar (Louis Pasteur),SAU Pasteur,1,18,108,127,23,8,2
26/10/2013,CH de Guebwiller,UHTCD,0,2,34,36,1,0,1
26/10/2013,CH de Mulhouse ( Hasenrain),PEDIATRIE NEONATOLOGIE,19,0,25,44,3,1,0
26/10/2013,CH de Mulhouse (Emile Muller-Moenschberg,URGENCES,0,20,108,128,12,10,1
26/10/2013,CH de Saverne,S.A.U. (ADULTES),0,9,34,43,5,1,0
26/10/2013,CH de Saverne,PEDIATRIE,3,0,11,14,1,0,0
26/10/2013,CH de Thann,Urgences,1,7,36,44,1,0,0
26/10/2013,CH de Wissembourg,Urgences ,1,6,45,52,8,1,1
26/10/2013,CHU de Strasbourg (Hôp. Civil),Urgences Médico-Chirurgicales NHC,0,18,98,116,46,3,2
26/10/2013,CHU de Strasbourg(Hautepierre),Urgences Adulte HTP,0,10,91,101,25,0,0
26/10/2013,CHU de Strasbourg(Hautepierre),Urgences chirurgicales pédiatriques,18,0,53,71,1,1,0
26/10/2013,CHU de Strasbourg(Hautepierre),Gynéco-Obstétrique (HTP),0,0,21,21,8,0,0
26/10/2013,CHU de Strasbourg(Hautepierre),Urgences chirurgicales pédiatriques,3,0,43,46,2,2,0
26/10/2013,Clinique des 3 Frontières,UPATOU (Structure des urgences),0,4,47,51,9,0,0
26/10/2013,Clinique des Diaconesses,SOS Main,0,1,36,37,0,0,0
26/10/2013,Clinique Ste Odile (Strasbourg,UPATOU,2,8,69,79,2,10,1
26/10/2013,CMCO,GYNECO-OBSTETRIQUE,0,0,0,0,0,0,0
26/10/2013,SIHCUS/CMCO,GYNECOLOGIE ET OBSTETRIQUE - CMCO,0,0,0,0,0,0,0
25/10/2013,CCOM,CCOM Chirurgie,0,1,27,28,1,0,0
25/10/2013,CH Altkirch,Upatou,1,5,27,33,4,1,3
25/10/2013,CH de Colmar (CMC Le Parc),SAU Le Parc,13,0,37,50,8,0,0
25/10/2013,CH de Colmar (Louis Pasteur),SAU Pasteur,0,19,106,125,31,11,2
25/10/2013,CH de Guebwiller,UHTCD,0,3,28,31,2,3,0
25/10/2013,CH de Mulhouse ( Hasenrain),PEDIATRIE NEONATOLOGIE,10,0,25,35,5,1,0
25/10/2013,CH de Mulhouse (Emile Muller-Moenschberg,URGENCES,0,21,104,125,18,11,3
25/10/2013,CH de Saverne,S.A.U. (ADULTES),0,20,45,65,15,5,1
25/10/2013,CH de Saverne,PEDIATRIE,4,0,16,20,2,0,0
25/10/2013,CH de Thann,Urgences,1,9,37,47,2,1,1
25/10/2013,CH de Wissembourg,Urgences ,0,8,28,36,13,2,1
25/10/2013,CHU de Strasbourg (Hôp. Civil),Urgences Médico-Chirurgicales NHC,0,17,71,88,46,7,1
25/10/2013,CHU de Strasbourg(Hautepierre),Urgences chirurgicales pédiatriques,12,0,35,47,8,8,0
25/10/2013,CHU de Strasbourg(Hautepierre),Gynéco-Obstétrique (HTP),0,0,29,29,11,0,0
25/10/2013,CHU de Strasbourg(Hautepierre),Urgences chirurgicales pédiatriques,2,0,29,31,1,1,0
25/10/2013,CHU de Strasbourg(Hautepierre),Urgences Adulte HTP,0,15,75,90,35,0,2
25/10/2013,Clinique des 3 Frontières,UPATOU (Structure des urgences),0,6,45,51,7,0,0
25/10/2013,Clinique Ste Odile (Strasbourg,UPATOU,0,5,64,69,7,8,0
25/10/2013,CMCO,GYNECO-OBSTETRIQUE,0,0,0,0,0,0,0
25/10/2013,SIHCUS/CMCO,GYNECOLOGIE ET OBSTETRIQUE - CMCO,0,0,0,0,0,0,0
24/10/2013,CCOM,CCOM Chirurgie,0,3,15,18,1,0,0
24/10/2013,CH Altkirch,Upatou,0,4,29,33,4,0,0
24/10/2013,CH de Colmar (CMC Le Parc),SAU Le Parc,2,0,31,33,5,1,0
24/10/2013,CH de Colmar (Louis Pasteur),SAU Pasteur,0,24,95,119,28,18,2
24/10/2013,CH de Guebwiller,UHTCD,0,10,33,43,5,5,3
24/10/2013,CH de Mulhouse ( Hasenrain),PEDIATRIE NEONATOLOGIE,16,0,19,35,7,1,0
24/10/2013,CH de Mulhouse (Emile Muller-Moenschberg,URGENCES,1,19,100,120,14,15,7
24/10/2013,CH de Saverne,S.A.U. (ADULTES),0,10,34,44,11,2,0
24/10/2013,CH de Saverne,PEDIATRIE,5,0,15,20,0,0,0
24/10/2013,CH de Thann,Urgences,0,8,29,37,2,2,3
24/10/2013,CH de Wissembourg,Urgences ,0,7,24,31,9,0,1
24/10/2013,CHU de Strasbourg (Hôp. Civil),Urgences Médico-Chirurgicales NHC,0,9,67,76,42,4,0
24/10/2013,CHU de Strasbourg(Hautepierre),Urgences chirurgicales pédiatriques,0,0,39,39,4,4,0
24/10/2013,CHU de Strasbourg(Hautepierre),Urgences chirurgicales pédiatriques,9,0,34,43,6,5,0
24/10/2013,CHU de Strasbourg(Hautepierre),Gynéco-Obstétrique (HTP),0,0,25,25,11,0,0
24/10/2013,CHU de Strasbourg(Hautepierre),Urgences Adulte HTP,0,18,75,93,31,0,0
24/10/2013,Clinique des 3 Frontières,UPATOU (Structure des urgences),0,2,36,38,8,0,1
24/10/2013,Clinique des Diaconesses,SOS Main,0,1,46,47,20,0,0
24/10/2013,Clinique Ste Odile (Strasbourg,UPATOU,0,3,55,58,2,5,0
24/10/2013,CMCO,GYNECO-OBSTETRIQUE,0,0,0,0,0,0,0
24/10/2013,SIHCUS/CMCO,GYNECOLOGIE ET OBSTETRIQUE - CMCO,0,0,0,0,0,0,0
23/10/2013,CCOM,CCOM Chirurgie,0,1,20,21,4,0,0
23/10/2013,CH Altkirch,Upatou,0,4,27,31,2,2,0
23/10/2013,CH de Colmar (CMC Le Parc),SAU Le Parc,7,0,38,45,9,0,0
23/10/2013,CH de Colmar (Louis Pasteur),SAU Pasteur,0,22,86,108,17,8,0
23/10/2013,CH de Guebwiller,UHTCD,0,6,27,33,5,2,2
23/10/2013,CH de Mulhouse ( Hasenrain),PEDIATRIE NEONATOLOGIE,12,0,24,36,7,0,0
23/10/2013,CH de Mulhouse (Emile Muller-Moenschberg,URGENCES,0,23,96,119,15,15,5
23/10/2013,CH de Saverne,PEDIATRIE,3,0,24,27,2,0,0
23/10/2013,CH de Saverne,S.A.U. (ADULTES),0,9,32,41,12,2,3
23/10/2013,CH de Thann,Urgences,1,4,33,38,2,2,2
23/10/2013,CH de Wissembourg,Urgences ,0,6,23,29,11,0,0
23/10/2013,CHU de Strasbourg (Hôp. Civil),Urgences Médico-Chirurgicales NHC,0,16,61,77,45,7,3
23/10/2013,CHU de Strasbourg(Hautepierre),Gynéco-Obstétrique (HTP),0,0,26,26,14,0,0
23/10/2013,CHU de Strasbourg(Hautepierre),Urgences chirurgicales pédiatriques,2,0,41,43,2,2,0
23/10/2013,CHU de Strasbourg(Hautepierre),Urgences Adulte HTP,1,19,78,98,46,0,0
23/10/2013,CHU de Strasbourg(Hautepierre),Urgences chirurgicales pédiatriques,7,0,32,39,7,7,0
23/10/2013,Clinique des 3 Frontières,UPATOU (Structure des urgences),0,5,39,44,5,0,0
23/10/2013,Clinique des Diaconesses,SOS Main,0,1,51,52,18,0,1
23/10/2013,Clinique Ste Odile (Strasbourg,UPATOU,1,7,47,55,1,5,2
23/10/2013,CMCO,GYNECO-OBSTETRIQUE,0,0,0,0,0,0,0
23/10/2013,SIHCUS/CMCO,GYNECOLOGIE ET OBSTETRIQUE - CMCO,0,0,0,0,0,0,0
22/10/2013,CCOM,CCOM Chirurgie,0,0,16,16,0,0,0
22/10/2013,CH Altkirch,Upatou,0,10,26,36,8,2,1
22/10/2013,CH de Colmar (CMC Le Parc),SAU Le Parc,14,0,35,49,10,0,0
22/10/2013,CH de Colmar (Louis Pasteur),SAU Pasteur,0,22,93,115,25,10,1
22/10/2013,CH de Guebwiller,UHTCD,0,2,41,43,0,1,1
22/10/2013,CH de Mulhouse ( Hasenrain),PEDIATRIE NEONATOLOGIE,13,0,18,31,4,1,0
22/10/2013,CH de Mulhouse (Emile Muller-Moenschberg,URGENCES,0,11,106,117,8,12,1
22/10/2013,CH de Saverne,PEDIATRIE,5,0,15,20,0,1,0
22/10/2013,CH de Saverne,S.A.U. (ADULTES),0,17,32,49,16,7,1
22/10/2013,CH de Thann,Urgences,1,11,29,41,4,3,0
22/10/2013,CH de Wissembourg,Urgences ,1,11,21,33,13,1,0
22/10/2013,CHU de Strasbourg (Hôp. Civil),Urgences Médico-Chirurgicales NHC,0,21,63,84,45,2,1
22/10/2013,CHU de Strasbourg(Hautepierre),Urgences chirurgicales pédiatriques,2,0,39,41,2,2,0
22/10/2013,CHU de Strasbourg(Hautepierre),Urgences Adulte HTP,0,15,88,103,36,0,0
22/10/2013,CHU de Strasbourg(Hautepierre),Urgences chirurgicales pédiatriques,16,0,50,66,9,9,0
22/10/2013,CHU de Strasbourg(Hautepierre),Gynéco-Obstétrique (HTP),0,0,27,27,7,0,0
22/10/2013,Clinique des 3 Frontières,UPATOU (Structure des urgences),1,3,45,49,5,0,0
22/10/2013,Clinique des Diaconesses,SOS Main,0,0,31,31,11,0,0
22/10/2013,Clinique Ste Odile (Strasbourg,UPATOU,0,2,62,64,2,6,2
22/10/2013,CMCO,GYNECO-OBSTETRIQUE,0,0,0,0,0,0,0
22/10/2013,SIHCUS/CMCO,GYNECOLOGIE ET OBSTETRIQUE - CMCO,0,0,0,0,0,0,0
21/10/2013,CCOM,CCOM Chirurgie,0,2,25,27,3,0,0
21/10/2013,CH Altkirch,Upatou,0,0,22,22,2,0,1
21/10/2013,CH de Colmar (CMC Le Parc),SAU Le Parc,8,0,34,42,6,0,0
21/10/2013,CH de Colmar (Louis Pasteur),SAU Pasteur,0,24,118,142,20,11,0
21/10/2013,CH de Guebwiller,UHTCD,0,3,40,43,2,1,1
21/10/2013,CH de Mulhouse ( Hasenrain),PEDIATRIE NEONATOLOGIE,14,0,16,30,4,0,0
21/10/2013,CH de Mulhouse (Emile Muller-Moenschberg,URGENCES,1,16,93,110,18,10,7
21/10/2013,CH de Saverne,PEDIATRIE,2,0,12,14,0,1,0
21/10/2013,CH de Saverne,S.A.U. (ADULTES),0,11,39,50,10,5,0
21/10/2013,CH de Thann,Urgences,0,4,40,44,4,1,2
21/10/2013,CH de Wissembourg,Urgences ,0,8,32,40,8,0,0
21/10/2013,CHU de Strasbourg (Hôp. Civil),Urgences Médico-Chirurgicales NHC,0,25,60,85,45,3,1
21/10/2013,CHU de Strasbourg(Hautepierre),Urgences chirurgicales pédiatriques,3,0,47,50,2,2,0
21/10/2013,CHU de Strasbourg(Hautepierre),Urgences Adulte HTP,0,16,76,92,30,0,0
21/10/2013,CHU de Strasbourg(Hautepierre),Urgences chirurgicales pédiatriques,18,0,45,63,8,7,0
21/10/2013,CHU de Strasbourg(Hautepierre),Gynéco-Obstétrique (HTP),0,0,34,34,16,0,0
21/10/2013,Clinique des 3 Frontières,UPATOU (Structure des urgences),0,7,35,42,9,0,0
21/10/2013,Clinique des Diaconesses,SOS Main,0,2,41,43,0,0,0
21/10/2013,Clinique Ste Odile (Strasbourg,UPATOU,1,3,79,83,1,11,9
21/10/2013,CMCO,GYNECO-OBSTETRIQUE,0,0,0,0,0,0,0
21/10/2013,SIHCUS/CMCO,GYNECOLOGIE ET OBSTETRIQUE - CMCO,0,0,0,0,0,0,0
20/10/2013,CCOM,CCOM Chirurgie,0,1,27,28,2,0,0
20/10/2013,CH Altkirch,Upatou,0,5,37,42,6,2,4
20/10/2013,CH de Colmar (CMC Le Parc),SAU Le Parc,11,0,45,56,6,0,0
20/10/2013,CH de Colmar (Louis Pasteur),SAU Pasteur,0,15,98,113,16,12,0
20/10/2013,CH de Guebwiller,UHTCD,0,4,41,45,5,1,3
20/10/2013,CH de Mulhouse ( Hasenrain),PEDIATRIE NEONATOLOGIE,11,0,34,45,6,1,1
20/10/2013,CH de Mulhouse (Emile Muller-Moenschberg,URGENCES,1,20,118,139,10,12,5
20/10/2013,CH de Saverne,S.A.U. (ADULTES),0,12,36,48,9,5,1
20/10/2013,CH de Saverne,PEDIATRIE,8,0,17,25,3,0,0
20/10/2013,CH de Thann,Urgences,1,7,26,34,2,0,2
20/10/2013,CHU de Strasbourg (Hôp. Civil),Urgences Médico-Chirurgicales NHC,0,16,62,78,34,5,0
20/10/2013,CHU de Strasbourg(Hautepierre),Urgences chirurgicales pédiatriques,3,0,36,39,4,4,0
20/10/2013,CHU de Strasbourg(Hautepierre),Urgences chirurgicales pédiatriques,18,0,46,64,5,5,0
20/10/2013,CHU de Strasbourg(Hautepierre),Gynéco-Obstétrique (HTP),0,0,27,27,8,0,0
20/10/2013,CHU de Strasbourg(Hautepierre),Urgences Adulte HTP,0,14,81,95,19,0,1
20/10/2013,Clinique des 3 Frontières,UPATOU (Structure des urgences),0,5,39,44,5,0,0
20/10/2013,Clinique Ste Odile (Strasbourg,UPATOU,2,6,79,87,0,5,2
20/10/2013,CMCO,GYNECO-OBSTETRIQUE,0,0,0,0,0,0,0
20/10/2013,SIHCUS/CMCO,GYNECOLOGIE ET OBSTETRIQUE - CMCO,0,0,0,0,0,0,0
19/10/2013,CCOM,CCOM Chirurgie,0,0,28,28,3,0,0
19/10/2013,CH Altkirch,Upatou,0,7,49,56,11,3,2
19/10/2013,CH de Colmar (CMC Le Parc),SAU Le Parc,9,0,41,50,5,0,0
19/10/2013,CH de Colmar (Louis Pasteur),SAU Pasteur,0,21,103,124,29,12,5
19/10/2013,CH de Guebwiller,UHTCD,0,4,39,43,5,3,1
19/10/2013,CH de Mulhouse ( Hasenrain),PEDIATRIE NEONATOLOGIE,12,0,20,32,5,0,0
19/10/2013,CH de Mulhouse (Emile Muller-Moenschberg,URGENCES,1,25,145,171,18,11,7
19/10/2013,CH de Saverne,S.A.U. (ADULTES),0,13,40,53,10,2,0
19/10/2013,CH de Saverne,PEDIATRIE,3,0,15,18,1,2,0
19/10/2013,CH de Thann,Urgences,0,7,40,47,3,0,2
19/10/2013,CHU de Strasbourg (Hôp. Civil),Urgences Médico-Chirurgicales NHC,0,17,83,100,42,6,3
19/10/2013,CHU de Strasbourg(Hautepierre),Urgences chirurgicales pédiatriques,14,0,47,61,8,8,0
19/10/2013,CHU de Strasbourg(Hautepierre),Gynéco-Obstétrique (HTP),0,0,28,28,9,0,0
19/10/2013,CHU de Strasbourg(Hautepierre),Urgences chirurgicales pédiatriques,3,0,57,60,6,6,0
19/10/2013,CHU de Strasbourg(Hautepierre),Urgences Adulte HTP,0,22,90,112,25,0,0
19/10/2013,Clinique des 3 Frontières,UPATOU (Structure des urgences),0,5,44,49,8,0,4
19/10/2013,Clinique Ste Odile (Strasbourg,UPATOU,0,3,68,71,1,5,0
19/10/2013,CMCO,GYNECO-OBSTETRIQUE,0,0,0,0,0,0,0
19/10/2013,SIHCUS/CMCO,GYNECOLOGIE ET OBSTETRIQUE - CMCO,0,0,0,0,0,0,0
18/10/2013,CCOM,CCOM Chirurgie,0,1,29,30,0,0,0
18/10/2013,CH Altkirch,Upatou,0,9,28,37,10,0,0
18/10/2013,CH de Colmar (CMC Le Parc),SAU Le Parc,5,0,37,42,7,0,0
18/10/2013,CH de Colmar (Louis Pasteur),SAU Pasteur,0,17,85,102,26,7,3
18/10/2013,CH de Guebwiller,UHTCD,0,5,34,39,2,1,0
18/10/2013,CH de Mulhouse ( Hasenrain),PEDIATRIE NEONATOLOGIE,11,0,25,36,3,1,0
18/10/2013,CH de Mulhouse (Emile Muller-Moenschberg,URGENCES,1,30,112,143,16,12,3
18/10/2013,CH de Saverne,PEDIATRIE,4,0,18,22,3,3,0
18/10/2013,CH de Saverne,S.A.U. (ADULTES),0,12,42,54,11,1,1
18/10/2013,CH de Thann,Urgences,0,6,41,47,5,0,2
18/10/2013,CHU de Strasbourg (Hôp. Civil),Urgences Médico-Chirurgicales NHC,0,12,67,79,28,2,1
18/10/2013,CHU de Strasbourg(Hautepierre),Urgences chirurgicales pédiatriques,3,0,48,51,7,5,0
18/10/2013,CHU de Strasbourg(Hautepierre),Urgences chirurgicales pédiatriques,11,0,34,45,11,11,0
18/10/2013,CHU de Strasbourg(Hautepierre),Gynéco-Obstétrique (HTP),0,0,23,23,11,0,0
18/10/2013,CHU de Strasbourg(Hautepierre),Urgences Adulte HTP,0,17,73,90,29,1,2
18/10/2013,Clinique des 3 Frontières,UPATOU (Structure des urgences),1,2,32,35,3,0,0
18/10/2013,Clinique des Diaconesses,SOS Main,0,2,42,44,0,9,0
18/10/2013,Clinique Ste Odile (Strasbourg,UPATOU,0,2,67,69,3,6,2
18/10/2013,CMCO,GYNECO-OBSTETRIQUE,0,0,0,0,0,0,0
18/10/2013,SIHCUS/CMCO,GYNECOLOGIE ET OBSTETRIQUE - CMCO,0,0,0,0,0,0,0
17/10/2013,CCOM,CCOM Chirurgie,0,4,27,31,1,0,0
17/10/2013,CH Altkirch,Upatou,0,7,41,48,6,2,3
17/10/2013,CH de Colmar (CMC Le Parc),SAU Le Parc,7,0,30,37,5,0,0
17/10/2013,CH de Colmar (Louis Pasteur),SAU Pasteur,0,27,105,132,30,12,0
17/10/2013,CH de Guebwiller,UHTCD,0,8,28,36,3,1,3
17/10/2013,CH de Mulhouse ( Hasenrain),PEDIATRIE NEONATOLOGIE,14,0,36,50,10,1,0
17/10/2013,CH de Mulhouse (Emile Muller-Moenschberg,URGENCES,0,21,103,124,16,7,4
17/10/2013,CH de Saverne,S.A.U. (ADULTES),0,14,41,55,12,6,0
17/10/2013,CH de Saverne,PEDIATRIE,12,0,13,25,1,1,0
17/10/2013,CH de Thann,Urgences,2,3,32,37,5,3,0
17/10/2013,CH de Wissembourg,Urgences ,0,3,21,24,6,0,0
17/10/2013,CHU de Strasbourg (Hôp. Civil),Urgences Médico-Chirurgicales NHC,0,17,69,86,35,4,0
17/10/2013,CHU de Strasbourg(Hautepierre),Urgences chirurgicales pédiatriques,19,0,32,51,5,6,0
17/10/2013,CHU de Strasbourg(Hautepierre),Gynéco-Obstétrique (HTP),0,0,26,26,16,0,0
17/10/2013,CHU de Strasbourg(Hautepierre),Urgences Adulte HTP,0,19,76,95,42,0,1
17/10/2013,CHU de Strasbourg(Hautepierre),Urgences chirurgicales pédiatriques,5,0,48,53,6,7,0
17/10/2013,Clinique des 3 Frontières,UPATOU (Structure des urgences),1,3,42,46,3,0,1
17/10/2013,Clinique Ste Odile (Strasbourg,UPATOU,2,4,66,72,1,4,1
17/10/2013,CMCO,GYNECO-OBSTETRIQUE,0,0,0,0,0,0,0
17/10/2013,SIHCUS/CMCO,GYNECOLOGIE ET OBSTETRIQUE - CMCO,0,0,0,0,0,0,0
16/10/2013,CCOM,CCOM Chirurgie,0,1,29,30,4,0,0
16/10/2013,CH Altkirch,Upatou,0,6,35,41,6,0,0
16/10/2013,CH de Colmar (CMC Le Parc),SAU Le Parc,9,0,37,46,7,0,0
16/10/2013,CH de Colmar (Louis Pasteur),SAU Pasteur,0,21,115,136,22,10,0
16/10/2013,CH de Guebwiller,UHTCD,0,6,54,60,0,2,1
16/10/2013,CH de Mulhouse ( Hasenrain),PEDIATRIE NEONATOLOGIE,13,0,23,36,9,0,0
16/10/2013,CH de Mulhouse (Emile Muller-Moenschberg,URGENCES,0,26,106,132,25,13,5
16/10/2013,CH de Saverne,PEDIATRIE,6,0,15,21,1,0,0
16/10/2013,CH de Saverne,S.A.U. (ADULTES),0,10,32,42,11,1,0
16/10/2013,CH de Thann,Urgences,0,6,32,38,3,0,2
16/10/2013,CH de Wissembourg,Urgences ,0,12,34,46,12,2,2
16/10/2013,CHU de Strasbourg (Hôp. Civil),Urgences Médico-Chirurgicales NHC,0,14,57,71,36,7,4
16/10/2013,CHU de Strasbourg(Hautepierre),Urgences chirurgicales pédiatriques,9,0,36,45,8,8,0
16/10/2013,CHU de Strasbourg(Hautepierre),Gynéco-Obstétrique (HTP),0,1,22,23,8,0,0
16/10/2013,CHU de Strasbourg(Hautepierre),Urgences chirurgicales pédiatriques,2,0,41,43,6,6,0
16/10/2013,CHU de Strasbourg(Hautepierre),Urgences Adulte HTP,0,18,78,96,32,1,0
16/10/2013,Clinique des 3 Frontières,UPATOU (Structure des urgences),1,4,34,39,2,0,1
16/10/2013,Clinique Ste Odile (Strasbourg,UPATOU,0,4,44,48,0,3,0
16/10/2013,CMCO,GYNECO-OBSTETRIQUE,0,0,0,0,0,0,0
16/10/2013,SIHCUS/CMCO,GYNECOLOGIE ET OBSTETRIQUE - CMCO,0,0,0,0,0,0,0
15/10/2013,CCOM,CCOM Chirurgie,0,2,29,31,2,0,0
15/10/2013,CH Altkirch,Upatou,1,5,35,41,8,1,2
15/10/2013,CH de Colmar (CMC Le Parc),SAU Le Parc,10,0,43,53,11,0,1
15/10/2013,CH de Colmar (Louis Pasteur),SAU Pasteur,0,22,93,115,25,11,0
15/10/2013,CH de Guebwiller,UHTCD,0,3,28,31,3,4,2
15/10/2013,CH de Mulhouse ( Hasenrain),PEDIATRIE NEONATOLOGIE,9,0,24,33,6,1,0
15/10/2013,CH de Mulhouse (Emile Muller-Moenschberg,URGENCES,0,14,105,119,14,9,2
15/10/2013,CH de Saverne,PEDIATRIE,3,0,13,16,2,0,0
15/10/2013,CH de Saverne,S.A.U. (ADULTES),0,6,41,47,6,6,0
15/10/2013,CH de Thann,Urgences,1,6,21,28,0,1,1
15/10/2013,CH de Wissembourg,Urgences ,0,4,22,26,5,2,1
15/10/2013,CHU de Strasbourg (Hôp. Civil),Urgences Médico-Chirurgicales NHC,0,13,62,75,40,8,1
15/10/2013,CHU de Strasbourg(Hautepierre),Urgences Adulte HTP,0,11,73,84,23,0,0
15/10/2013,CHU de Strasbourg(Hautepierre),Urgences chirurgicales pédiatriques,3,0,45,48,3,3,0
15/10/2013,CHU de Strasbourg(Hautepierre),Urgences chirurgicales pédiatriques,13,0,43,56,7,6,0
15/10/2013,CHU de Strasbourg(Hautepierre),Gynéco-Obstétrique (HTP),0,0,31,31,17,0,0
15/10/2013,Clinique des 3 Frontières,UPATOU (Structure des urgences),0,6,33,39,4,1,0
15/10/2013,Clinique Ste Odile (Strasbourg,UPATOU,1,4,60,65,1,6,3
15/10/2013,CMCO,GYNECO-OBSTETRIQUE,0,0,0,0,0,0,0
15/10/2013,SIHCUS/CMCO,GYNECOLOGIE ET OBSTETRIQUE - CMCO,0,0,0,0,0,0,0
14/10/2013,CCOM,CCOM Chirurgie,0,1,33,34,1,0,0
14/10/2013,CH Altkirch,Upatou,0,6,31,37,6,0,0
14/10/2013,CH de Colmar (CMC Le Parc),SAU Le Parc,6,0,44,50,9,0,0
14/10/2013,CH de Colmar (Louis Pasteur),SAU Pasteur,0,25,88,113,21,10,2
14/10/2013,CH de Guebwiller,UHTCD,0,5,44,49,4,1,2
14/10/2013,CH de Mulhouse ( Hasenrain),PEDIATRIE NEONATOLOGIE,11,0,31,42,7,0,0
14/10/2013,CH de Mulhouse (Emile Muller-Moenschberg,URGENCES,2,26,102,130,17,12,4
14/10/2013,CH de Saverne,PEDIATRIE,4,0,14,18,2,0,0
14/10/2013,CH de Saverne,S.A.U. (ADULTES),0,14,46,60,7,7,0
14/10/2013,CH de Wissembourg,Urgences ,0,1,25,26,4,0,1
14/10/2013,CHU de Strasbourg (Hôp. Civil),Urgences Médico-Chirurgicales NHC,0,21,67,88,52,4,1
14/10/2013,CHU de Strasbourg(Hautepierre),Urgences chirurgicales pédiatriques,5,0,47,52,5,4,0
14/10/2013,CHU de Strasbourg(Hautepierre),Urgences Adulte HTP,0,17,66,83,26,0,0
14/10/2013,CHU de Strasbourg(Hautepierre),Urgences chirurgicales pédiatriques,12,0,38,50,6,6,0
14/10/2013,CHU de Strasbourg(Hautepierre),Gynéco-Obstétrique (HTP),1,0,28,29,8,0,0
14/10/2013,Clinique des 3 Frontières,UPATOU (Structure des urgences),0,4,43,47,1,0,0
14/10/2013,Clinique Ste Odile (Strasbourg,UPATOU,0,4,63,67,3,4,0
14/10/2013,CMCO,GYNECO-OBSTETRIQUE,0,0,0,0,0,0,0
14/10/2013,SIHCUS/CMCO,GYNECOLOGIE ET OBSTETRIQUE - CMCO,0,0,0,0,0,0,0
13/10/2013,CCOM,CCOM Chirurgie,0,1,19,20,1,0,0
13/10/2013,CH Altkirch,Upatou,0,7,36,43,5,1,0
13/10/2013,CH de Colmar (CMC Le Parc),SAU Le Parc,9,0,48,57,8,0,0
13/10/2013,CH de Colmar (Louis Pasteur),SAU Pasteur,0,15,114,129,21,13,0
13/10/2013,CH de Guebwiller,UHTCD,0,2,34,36,1,2,1
13/10/2013,CH de Mulhouse ( Hasenrain),PEDIATRIE NEONATOLOGIE,11,0,35,46,5,2,0
13/10/2013,CH de Mulhouse (Emile Muller-Moenschberg,URGENCES,1,21,112,134,12,10,3
13/10/2013,CH de Saverne,PEDIATRIE,9,0,20,29,1,1,0
13/10/2013,CH de Saverne,S.A.U. (ADULTES),0,11,41,52,8,3,0
13/10/2013,CH de Thann,Urgences,0,6,30,36,1,1,2
13/10/2013,CH de Wissembourg,Urgences ,1,3,34,38,6,1,0
13/10/2013,CHU de Strasbourg (Hôp. Civil),Urgences Médico-Chirurgicales NHC,0,13,79,92,24,5,1
13/10/2013,CHU de Strasbourg(Hautepierre),Urgences chirurgicales pédiatriques,4,0,52,56,3,3,0
13/10/2013,CHU de Strasbourg(Hautepierre),Urgences chirurgicales pédiatriques,18,0,45,63,6,6,0
13/10/2013,CHU de Strasbourg(Hautepierre),Gynéco-Obstétrique (HTP),0,0,23,23,7,0,0
13/10/2013,CHU de Strasbourg(Hautepierre),Urgences Adulte HTP,0,10,78,88,22,0,0
13/10/2013,Clinique des 3 Frontières,UPATOU (Structure des urgences),1,6,43,50,2,0,0
13/10/2013,Clinique Ste Odile (Strasbourg,UPATOU,1,6,97,104,1,5,1
13/10/2013,CMCO,GYNECO-OBSTETRIQUE,0,0,0,0,0,0,0
13/10/2013,SIHCUS/CMCO,GYNECOLOGIE ET OBSTETRIQUE - CMCO,0,0,0,0,0,0,0
12/10/2013,CCOM,CCOM Chirurgie,0,1,8,9,1,0,0
12/10/2013,CH Altkirch,Upatou,1,10,22,33,6,0,0
12/10/2013,CH de Colmar (CMC Le Parc),SAU Le Parc,9,0,41,50,4,0,0
12/10/2013,CH de Colmar (Louis Pasteur),SAU Pasteur,0,22,110,132,23,9,3
12/10/2013,CH de Guebwiller,UHTCD,0,5,27,32,4,1,0
12/10/2013,CH de Mulhouse ( Hasenrain),PEDIATRIE NEONATOLOGIE,17,0,29,46,6,1,0
12/10/2013,CH de Mulhouse (Emile Muller-Moenschberg,URGENCES,1,23,126,150,12,14,3
12/10/2013,CH de Saverne,S.A.U. (ADULTES),0,7,47,54,7,0,2
12/10/2013,CH de Saverne,PEDIATRIE,10,0,16,26,1,0,0
12/10/2013,CH de Thann,Urgences,1,8,39,48,3,1,0
12/10/2013,CH de Wissembourg,Urgences ,3,4,48,55,6,0,0
12/10/2013,CHU de Strasbourg (Hôp. Civil),Urgences Médico-Chirurgicales NHC,0,15,93,108,40,6,1
12/10/2013,CHU de Strasbourg(Hautepierre),Urgences chirurgicales pédiatriques,1,0,36,37,1,1,0
12/10/2013,CHU de Strasbourg(Hautepierre),Urgences Adulte HTP,0,19,81,100,32,0,0
12/10/2013,CHU de Strasbourg(Hautepierre),Urgences chirurgicales pédiatriques,11,0,38,49,7,7,0
12/10/2013,CHU de Strasbourg(Hautepierre),Gynéco-Obstétrique (HTP),0,0,28,28,13,0,0
12/10/2013,Clinique des 3 Frontières,UPATOU (Structure des urgences),0,2,40,42,4,0,0
12/10/2013,Clinique Ste Odile (Strasbourg,UPATOU,1,6,79,86,2,5,2
12/10/2013,CMCO,GYNECO-OBSTETRIQUE,0,0,0,0,0,0,0
12/10/2013,SIHCUS/CMCO,GYNECOLOGIE ET OBSTETRIQUE - CMCO,0,0,0,0,0,0,0
11/10/2013,CCOM,CCOM Chirurgie,0,2,29,31,3,0,0
11/10/2013,CH Altkirch,Upatou,1,3,38,42,2,0,0
11/10/2013,CH de Colmar (CMC Le Parc),SAU Le Parc,5,0,40,45,7,0,0
11/10/2013,CH de Colmar (Louis Pasteur),SAU Pasteur,0,16,113,129,20,11,3
11/10/2013,CH de Guebwiller,UHTCD,1,6,29,36,1,3,1
11/10/2013,CH de Mulhouse ( Hasenrain),PEDIATRIE NEONATOLOGIE,15,0,17,32,7,2,0
11/10/2013,CH de Mulhouse (Emile Muller-Moenschberg,URGENCES,1,19,124,144,26,12,5
11/10/2013,CH de Saverne,S.A.U. (ADULTES),0,9,42,51,10,4,2
11/10/2013,CH de Saverne,PEDIATRIE,6,0,20,26,1,3,1
11/10/2013,CH de Thann,Urgences,0,11,31,42,4,2,2
11/10/2013,CH de Wissembourg,Urgences ,0,5,26,31,3,0,2
11/10/2013,CHU de Strasbourg (Hôp. Civil),Urgences Médico-Chirurgicales NHC,0,18,53,71,31,3,1
11/10/2013,CHU de Strasbourg(Hautepierre),Urgences chirurgicales pédiatriques,3,0,38,41,5,5,0
11/10/2013,CHU de Strasbourg(Hautepierre),Urgences chirurgicales pédiatriques,15,0,27,42,3,3,0
11/10/2013,CHU de Strasbourg(Hautepierre),Gynéco-Obstétrique (HTP),0,0,28,28,15,0,0
11/10/2013,CHU de Strasbourg(Hautepierre),Urgences Adulte HTP,0,13,83,96,31,0,0
11/10/2013,Clinique des 3 Frontières,UPATOU (Structure des urgences),0,4,39,43,6,0,1
11/10/2013,Clinique des Diaconesses,SOS Main,0,2,45,47,1,0,0
11/10/2013,Clinique Ste Odile (Strasbourg,UPATOU,0,5,62,67,2,11,1
11/10/2013,CMCO,GYNECO-OBSTETRIQUE,0,0,0,0,0,0,0
11/10/2013,SIHCUS/CMCO,GYNECOLOGIE ET OBSTETRIQUE - CMCO,0,0,0,0,0,0,0
10/10/2013,CCOM,CCOM Chirurgie,0,0,13,13,0,0,0
10/10/2013,CH Altkirch,Upatou,0,6,26,32,5,1,0
10/10/2013,CH de Colmar (CMC Le Parc),SAU Le Parc,9,0,44,53,9,0,0
10/10/2013,CH de Colmar (Louis Pasteur),SAU Pasteur,0,26,102,128,14,17,1
10/10/2013,CH de Guebwiller,UHTCD,0,6,35,41,2,1,0
10/10/2013,CH de Mulhouse ( Hasenrain),PEDIATRIE NEONATOLOGIE,8,0,28,36,8,4,0
10/10/2013,CH de Mulhouse (Emile Muller-Moenschberg,URGENCES,1,15,94,110,9,9,2
10/10/2013,CH de Saverne,S.A.U. (ADULTES),0,13,40,53,10,3,0
10/10/2013,CH de Saverne,PEDIATRIE,5,0,21,26,5,1,0
10/10/2013,CH de Thann,Urgences,0,7,30,37,3,1,1
10/10/2013,CH de Wissembourg,Urgences ,0,6,33,39,9,0,2
10/10/2013,CHU de Strasbourg (Hôp. Civil),Urgences Médico-Chirurgicales NHC,0,24,59,83,44,1,2
10/10/2013,CHU de Strasbourg(Hautepierre),Urgences chirurgicales pédiatriques,13,0,35,48,9,9,0
10/10/2013,CHU de Strasbourg(Hautepierre),Gynéco-Obstétrique (HTP),1,0,23,24,14,0,0
10/10/2013,CHU de Strasbourg(Hautepierre),Urgences chirurgicales pédiatriques,1,0,42,43,5,4,0
10/10/2013,CHU de Strasbourg(Hautepierre),Urgences Adulte HTP,0,15,85,100,32,0,2
10/10/2013,Clinique des 3 Frontières,UPATOU (Structure des urgences),0,7,30,37,2,0,1
10/10/2013,Clinique Ste Odile (Strasbourg,UPATOU,0,3,54,57,3,4,0
10/10/2013,CMCO,GYNECO-OBSTETRIQUE,0,0,0,0,0,0,0
10/10/2013,SIHCUS/CMCO,GYNECOLOGIE ET OBSTETRIQUE - CMCO,0,0,0,0,0,0,0
9/10/2013,CCOM,CCOM Chirurgie,0,1,20,21,0,0,0
9/10/2013,CH Altkirch,Upatou,0,6,30,36,9,2,1
9/10/2013,CH de Colmar (CMC Le Parc),SAU Le Parc,6,0,47,53,12,0,0
9/10/2013,CH de Colmar (Louis Pasteur),SAU Pasteur,0,19,104,123,19,9,1
9/10/2013,CH de Guebwiller,UHTCD,0,4,40,44,5,0,0
9/10/2013,CH de Mulhouse ( Hasenrain),PEDIATRIE NEONATOLOGIE,7,0,31,38,4,1,0
9/10/2013,CH de Mulhouse (Emile Muller-Moenschberg,URGENCES,3,21,106,130,7,11,6
9/10/2013,CH de Saverne,PEDIATRIE,6,0,15,21,4,2,0
9/10/2013,CH de Saverne,S.A.U. (ADULTES),0,9,40,49,5,2,0
9/10/2013,CH de Thann,Urgences,0,9,28,37,5,1,2
9/10/2013,CH de Wissembourg,Urgences ,0,6,28,34,8,0,3
9/10/2013,CHU de Strasbourg (Hôp. Civil),Urgences Médico-Chirurgicales NHC,0,14,65,79,42,4,2
9/10/2013,CHU de Strasbourg(Hautepierre),Urgences chirurgicales pédiatriques,1,0,38,39,5,5,0
9/10/2013,CHU de Strasbourg(Hautepierre),Urgences chirurgicales pédiatriques,13,0,32,45,5,4,0
9/10/2013,CHU de Strasbourg(Hautepierre),Gynéco-Obstétrique (HTP),0,0,27,27,11,0,0
9/10/2013,CHU de Strasbourg(Hautepierre),Urgences Adulte HTP,0,16,61,77,27,0,2
9/10/2013,Clinique des 3 Frontières,UPATOU (Structure des urgences),0,7,9,16,3,0,1
9/10/2013,Clinique des Diaconesses,SOS Main,0,1,41,42,21,0,1
9/10/2013,Clinique Ste Odile (Strasbourg,UPATOU,0,6,82,88,4,9,4
9/10/2013,CMCO,GYNECO-OBSTETRIQUE,0,0,0,0,0,0,0
9/10/2013,SIHCUS/CMCO,GYNECOLOGIE ET OBSTETRIQUE - CMCO,0,0,0,0,0,0,0
8/10/2013,CCOM,CCOM Chirurgie,0,1,18,19,2,0,0
8/10/2013,CH Altkirch,Upatou,0,8,32,40,8,1,2
8/10/2013,CH de Colmar (CMC Le Parc),SAU Le Parc,3,0,40,43,8,0,0
8/10/2013,CH de Colmar (Louis Pasteur),SAU Pasteur,0,23,109,132,27,13,2
8/10/2013,CH de Guebwiller,UHTCD,1,5,38,44,3,1,0
8/10/2013,CH de Mulhouse ( Hasenrain),PEDIATRIE NEONATOLOGIE,11,0,17,28,7,1,0
8/10/2013,CH de Mulhouse (Emile Muller-Moenschberg,URGENCES,0,22,102,124,10,15,2
8/10/2013,CH de Saverne,S.A.U. (ADULTES),0,13,35,48,9,3,0
8/10/2013,CH de Saverne,PEDIATRIE,5,0,12,17,3,0,0
8/10/2013,CH de Thann,Urgences,1,7,28,36,1,1,0
8/10/2013,CH de Wissembourg,Urgences ,3,8,30,41,8,0,1
8/10/2013,CHU de Strasbourg (Hôp. Civil),Urgences Médico-Chirurgicales NHC,0,16,53,69,44,10,3
8/10/2013,CHU de Strasbourg(Hautepierre),Urgences chirurgicales pédiatriques,4,0,51,55,5,5,0
8/10/2013,CHU de Strasbourg(Hautepierre),Urgences Adulte HTP,0,14,64,78,31,0,0
8/10/2013,CHU de Strasbourg(Hautepierre),Urgences chirurgicales pédiatriques,18,0,29,47,7,8,0
8/10/2013,CHU de Strasbourg(Hautepierre),Gynéco-Obstétrique (HTP),0,0,35,35,16,0,0
8/10/2013,Clinique des 3 Frontières,UPATOU (Structure des urgences),0,4,30,34,5,0,0
8/10/2013,Clinique des Diaconesses,SOS Main,0,0,50,50,17,0,0
8/10/2013,Clinique Ste Odile (Strasbourg,UPATOU,0,6,64,70,3,3,3
8/10/2013,CMCO,GYNECO-OBSTETRIQUE,0,0,0,0,0,0,0
8/10/2013,SIHCUS/CMCO,GYNECOLOGIE ET OBSTETRIQUE - CMCO,0,0,0,0,0,0,0
7/10/2013,CCOM,CCOM Chirurgie,0,4,22,26,0,0,0
7/10/2013,CH Altkirch,Upatou,0,4,29,33,2,0,1
7/10/2013,CH de Colmar (CMC Le Parc),SAU Le Parc,3,0,31,34,4,0,0
7/10/2013,CH de Colmar (Louis Pasteur),SAU Pasteur,0,24,121,145,28,14,1
7/10/2013,CH de Guebwiller,UHTCD,0,5,48,53,1,2,1
7/10/2013,CH de Mulhouse ( Hasenrain),PEDIATRIE NEONATOLOGIE,7,0,20,27,2,2,0
7/10/2013,CH de Mulhouse (Emile Muller-Moenschberg,URGENCES,0,24,113,137,17,17,2
7/10/2013,CH de Saverne,S.A.U. (ADULTES),0,10,58,68,13,1,0
7/10/2013,CH de Saverne,PEDIATRIE,4,0,19,23,1,2,0
7/10/2013,CH de Thann,Urgences,1,3,35,39,3,1,1
7/10/2013,CH de Wissembourg,Urgences ,1,5,25,31,10,0,0
7/10/2013,CHU de Strasbourg (Hôp. Civil),Urgences Médico-Chirurgicales NHC,0,9,58,67,35,4,4
7/10/2013,CHU de Strasbourg(Hautepierre),Urgences Adulte HTP,0,21,67,88,42,0,2
7/10/2013,CHU de Strasbourg(Hautepierre),Urgences chirurgicales pédiatriques,13,0,43,56,7,7,0
7/10/2013,CHU de Strasbourg(Hautepierre),Gynéco-Obstétrique (HTP),0,0,29,29,13,0,0
7/10/2013,CHU de Strasbourg(Hautepierre),Urgences chirurgicales pédiatriques,1,0,41,42,4,4,0
7/10/2013,Clinique des 3 Frontières,UPATOU (Structure des urgences),0,3,50,53,7,0,0
7/10/2013,Clinique des Diaconesses,SOS Main,0,0,45,45,14,0,0
7/10/2013,Clinique Ste Odile (Strasbourg,UPATOU,0,3,66,69,0,9,1
7/10/2013,CMCO,GYNECO-OBSTETRIQUE,0,0,0,0,0,0,0
7/10/2013,SIHCUS/CMCO,GYNECOLOGIE ET OBSTETRIQUE - CMCO,0,0,0,0,0,0,0
6/10/2013,CCOM,CCOM Chirurgie,0,0,23,23,3,0,0
6/10/2013,CH Altkirch,Upatou,1,3,28,32,1,1,3
6/10/2013,CH de Colmar (CMC Le Parc),SAU Le Parc,5,0,56,61,9,0,1
6/10/2013,CH de Colmar (Louis Pasteur),SAU Pasteur,0,21,107,128,19,13,0
6/10/2013,CH de Guebwiller,UHTCD,1,2,43,46,4,0,6
6/10/2013,CH de Mulhouse ( Hasenrain),PEDIATRIE NEONATOLOGIE,11,0,25,36,5,1,0
6/10/2013,CH de Mulhouse (Emile Muller-Moenschberg,URGENCES,1,20,108,129,8,12,6
6/10/2013,CH de Saverne,S.A.U. (ADULTES),0,7,39,46,9,2,0
6/10/2013,CH de Saverne,PEDIATRIE,2,0,13,15,1,1,0
6/10/2013,CH de Thann,Urgences,0,2,46,48,2,2,2
6/10/2013,CH de Wissembourg,Urgences ,2,6,21,29,6,0,0
6/10/2013,CHU de Strasbourg (Hôp. Civil),Urgences Médico-Chirurgicales NHC,0,15,62,77,30,2,2
6/10/2013,CHU de Strasbourg(Hautepierre),Urgences chirurgicales pédiatriques,21,0,47,68,7,7,0
6/10/2013,CHU de Strasbourg(Hautepierre),Gynéco-Obstétrique (HTP),0,0,24,24,10,0,0
6/10/2013,CHU de Strasbourg(Hautepierre),Urgences Adulte HTP,0,13,67,80,22,0,0
6/10/2013,CHU de Strasbourg(Hautepierre),Urgences chirurgicales pédiatriques,2,0,36,38,0,0,0
6/10/2013,Clinique des 3 Frontières,UPATOU (Structure des urgences),1,1,44,46,3,0,0
6/10/2013,Clinique Ste Odile (Strasbourg,UPATOU,0,1,86,87,3,7,2
6/10/2013,CMCO,GYNECO-OBSTETRIQUE,0,0,0,0,0,0,0
6/10/2013,SIHCUS/CMCO,GYNECOLOGIE ET OBSTETRIQUE - CMCO,0,0,0,0,0,0,0
5/10/2013,CCOM,CCOM Chirurgie,0,2,32,34,5,0,0
5/10/2013,CH Altkirch,Upatou,0,2,36,38,4,1,4
5/10/2013,CH de Colmar (CMC Le Parc),SAU Le Parc,9,0,34,43,6,0,0
5/10/2013,CH de Colmar (Louis Pasteur),SAU Pasteur,0,11,117,128,24,9,3
5/10/2013,CH de Guebwiller,UHTCD,0,5,36,41,3,2,1
5/10/2013,CH de Mulhouse ( Hasenrain),PEDIATRIE NEONATOLOGIE,18,0,24,42,9,3,0
5/10/2013,CH de Mulhouse (Emile Muller-Moenschberg,URGENCES,1,19,103,123,10,8,3
5/10/2013,CH de Saverne,PEDIATRIE,5,0,13,18,4,0,0
5/10/2013,CH de Saverne,S.A.U. (ADULTES),0,7,45,52,10,3,0
5/10/2013,CH de Thann,Urgences,0,7,26,33,3,0,3
5/10/2013,CH de Wissembourg,Urgences ,0,1,19,20,0,1,0
5/10/2013,CHU de Strasbourg (Hôp. Civil),Urgences Médico-Chirurgicales NHC,0,17,79,96,35,4,1
5/10/2013,CHU de Strasbourg(Hautepierre),Urgences chirurgicales pédiatriques,15,0,40,55,6,6,0
5/10/2013,CHU de Strasbourg(Hautepierre),Gynéco-Obstétrique (HTP),0,0,31,31,8,0,0
5/10/2013,CHU de Strasbourg(Hautepierre),Urgences chirurgicales pédiatriques,2,0,42,44,5,5,0
5/10/2013,CHU de Strasbourg(Hautepierre),Urgences Adulte HTP,1,14,78,93,24,0,0
5/10/2013,Clinique des 3 Frontières,UPATOU (Structure des urgences),1,8,44,53,5,0,0
5/10/2013,Clinique Ste Odile (Strasbourg,UPATOU,1,8,75,84,1,4,1
5/10/2013,CMCO,GYNECO-OBSTETRIQUE,0,0,0,0,0,0,0
5/10/2013,SIHCUS/CMCO,GYNECOLOGIE ET OBSTETRIQUE - CMCO,0,0,0,0,0,0,0
4/10/2013,CCOM,CCOM Chirurgie,0,2,29,31,5,0,0
4/10/2013,CH Altkirch,Upatou,0,10,36,46,5,1,1
4/10/2013,CH de Colmar (CMC Le Parc),SAU Le Parc,7,0,39,46,7,0,0
4/10/2013,CH de Colmar (Louis Pasteur),SAU Pasteur,0,20,106,126,12,34,4
4/10/2013,CH de Guebwiller,UHTCD,0,7,39,46,5,4,2
4/10/2013,CH de Mulhouse ( Hasenrain),PEDIATRIE NEONATOLOGIE,8,0,22,30,7,1,0
4/10/2013,CH de Mulhouse (Emile Muller-Moenschberg,URGENCES,1,29,127,157,22,12,1
4/10/2013,CH de Saverne,PEDIATRIE,4,0,15,19,2,1,0
4/10/2013,CH de Saverne,S.A.U. (ADULTES),0,12,41,53,10,4,2
4/10/2013,CH de Thann,Urgences,0,6,34,40,0,1,2
4/10/2013,CH de Wissembourg,Urgences ,1,10,15,26,8,0,0
4/10/2013,CHU de Strasbourg (Hôp. Civil),Urgences Médico-Chirurgicales NHC,0,17,59,76,36,3,1
4/10/2013,CHU de Strasbourg(Hautepierre),Gynéco-Obstétrique (HTP),0,0,26,26,15,0,0
4/10/2013,CHU de Strasbourg(Hautepierre),Urgences Adulte HTP,0,17,84,101,37,0,0
4/10/2013,CHU de Strasbourg(Hautepierre),Urgences chirurgicales pédiatriques,1,0,48,49,6,6,0
4/10/2013,CHU de Strasbourg(Hautepierre),Urgences chirurgicales pédiatriques,8,0,27,35,7,6,0
4/10/2013,Clinique des 3 Frontières,UPATOU (Structure des urgences),0,7,24,31,8,0,1
4/10/2013,Clinique Ste Odile (Strasbourg,UPATOU,0,2,74,76,1,6,3
4/10/2013,CMCO,GYNECO-OBSTETRIQUE,0,0,0,0,0,0,0
4/10/2013,SIHCUS/CMCO,GYNECOLOGIE ET OBSTETRIQUE - CMCO,0,0,0,0,0,0,0
3/10/2013,CCOM,CCOM Chirurgie,0,0,28,28,3,0,0
3/10/2013,CH Altkirch,Upatou,0,7,31,38,8,1,2
3/10/2013,CH de Colmar (CMC Le Parc),SAU Le Parc,5,0,49,54,12,0,0
3/10/2013,CH de Colmar (Louis Pasteur),SAU Pasteur,0,11,117,128,20,11,2
3/10/2013,CH de Guebwiller,UHTCD,0,8,41,49,3,4,0
3/10/2013,CH de Mulhouse ( Hasenrain),PEDIATRIE NEONATOLOGIE,11,0,23,34,5,0,0
3/10/2013,CH de Mulhouse (Emile Muller-Moenschberg,URGENCES,0,27,97,124,22,13,6
3/10/2013,CH de Saverne,S.A.U. (ADULTES),0,5,37,42,5,2,0
3/10/2013,CH de Saverne,PEDIATRIE,2,0,18,20,3,2,0
3/10/2013,CH de Thann,Urgences,0,3,35,38,3,1,0
3/10/2013,CH de Wissembourg,Urgences ,0,3,26,29,5,0,0
3/10/2013,CHU de Strasbourg (Hôp. Civil),Urgences Médico-Chirurgicales NHC,0,16,48,64,32,8,0
3/10/2013,CHU de Strasbourg(Hautepierre),Urgences chirurgicales pédiatriques,9,0,47,56,8,7,0
3/10/2013,CHU de Strasbourg(Hautepierre),Gynéco-Obstétrique (HTP),0,1,24,25,7,0,0
3/10/2013,CHU de Strasbourg(Hautepierre),Urgences chirurgicales pédiatriques,1,0,64,65,5,5,0
3/10/2013,CHU de Strasbourg(Hautepierre),Urgences Adulte HTP,0,12,73,85,30,0,0
3/10/2013,Clinique des 3 Frontières,UPATOU (Structure des urgences),0,6,33,39,2,0,0
3/10/2013,Clinique des Diaconesses,SOS Main,0,0,20,20,3,0,0
3/10/2013,Clinique Ste Odile (Strasbourg,UPATOU,1,0,63,64,2,5,2
3/10/2013,CMCO,GYNECO-OBSTETRIQUE,0,0,0,0,0,0,0
3/10/2013,SIHCUS/CMCO,GYNECOLOGIE ET OBSTETRIQUE - CMCO,0,0,0,0,0,0,0
2/10/2013,CCOM,CCOM Chirurgie,0,2,31,33,5,0,0
2/10/2013,CH Altkirch,Upatou,0,5,33,38,6,1,0
2/10/2013,CH de Colmar (CMC Le Parc),SAU Le Parc,3,0,51,54,9,0,0
2/10/2013,CH de Colmar (Louis Pasteur),SAU Pasteur,0,23,95,118,17,8,0
2/10/2013,CH de Guebwiller,UHTCD,0,3,42,45,0,3,0
2/10/2013,CH de Mulhouse ( Hasenrain),PEDIATRIE NEONATOLOGIE,15,0,25,40,5,2,0
2/10/2013,CH de Mulhouse (Emile Muller-Moenschberg,URGENCES,1,17,103,121,14,11,1
2/10/2013,CH de Saverne,S.A.U. (ADULTES),0,6,39,45,7,3,0
2/10/2013,CH de Saverne,PEDIATRIE,7,0,17,24,3,1,0
2/10/2013,CH de Thann,Urgences,0,3,36,39,4,1,1
2/10/2013,CH de Wissembourg,Urgences ,0,8,25,33,6,1,2
2/10/2013,CHU de Strasbourg (Hôp. Civil),Urgences Médico-Chirurgicales NHC,0,13,55,68,43,6,2
2/10/2013,CHU de Strasbourg(Hautepierre),Urgences chirurgicales pédiatriques,11,0,30,41,10,8,0
2/10/2013,CHU de Strasbourg(Hautepierre),Gynéco-Obstétrique (HTP),0,0,29,29,14,0,0
2/10/2013,CHU de Strasbourg(Hautepierre),Urgences Adulte HTP,0,9,77,86,24,0,1
2/10/2013,CHU de Strasbourg(Hautepierre),Urgences chirurgicales pédiatriques,4,0,51,55,5,5,0
2/10/2013,Clinique des 3 Frontières,UPATOU (Structure des urgences),0,7,30,37,2,0,2
2/10/2013,Clinique des Diaconesses,SOS Main,0,2,46,48,14,0,0
2/10/2013,Clinique Ste Odile (Strasbourg,UPATOU,0,5,58,63,3,5,0
2/10/2013,CMCO,GYNECO-OBSTETRIQUE,0,0,0,0,0,0,0
2/10/2013,SIHCUS/CMCO,GYNECOLOGIE ET OBSTETRIQUE - CMCO,0,0,0,0,0,0,0
1/10/2013,CCOM,CCOM Chirurgie,0,2,33,35,3,0,0
1/10/2013,CH Altkirch,Upatou,0,3,3,6,6,0,0
1/10/2013,CH de Colmar (CMC Le Parc),SAU Le Parc,5,0,28,33,6,0,0
1/10/2013,CH de Colmar (Louis Pasteur),SAU Pasteur,0,20,95,115,16,11,0
1/10/2013,CH de Guebwiller,UHTCD,0,4,39,43,2,0,0
1/10/2013,CH de Mulhouse ( Hasenrain),PEDIATRIE NEONATOLOGIE,9,0,25,34,2,1,0
1/10/2013,CH de Mulhouse (Emile Muller-Moenschberg,URGENCES,1,23,100,124,19,10,2
1/10/2013,CH de Saverne,S.A.U. (ADULTES),0,8,50,58,16,5,2
1/10/2013,CH de Saverne,PEDIATRIE,5,0,23,28,4,1,0
1/10/2013,CH de Thann,Urgences,0,6,33,39,1,2,1
1/10/2013,CH de Wissembourg,Urgences ,0,4,22,26,2,1,0
1/10/2013,CHU de Strasbourg (Hôp. Civil),Urgences Médico-Chirurgicales NHC,1,20,59,80,45,5,1
1/10/2013,CHU de Strasbourg(Hautepierre),Urgences chirurgicales pédiatriques,6,0,46,52,3,3,0
1/10/2013,CHU de Strasbourg(Hautepierre),Urgences Adulte HTP,0,16,80,96,33,0,0
1/10/2013,CHU de Strasbourg(Hautepierre),Urgences chirurgicales pédiatriques,8,0,45,53,7,7,0
1/10/2013,CHU de Strasbourg(Hautepierre),Gynéco-Obstétrique (HTP),0,0,20,20,10,0,0
1/10/2013,Clinique des 3 Frontières,UPATOU (Structure des urgences),0,3,33,36,4,0,1
1/10/2013,Clinique des Diaconesses,SOS Main,0,0,31,31,9,0,0
1/10/2013,Clinique Ste Odile (Strasbourg,UPATOU,0,2,54,56,0,5,1
1/10/2013,CMCO,GYNECO-OBSTETRIQUE,0,0,0,0,0,0,0
1/10/2013,SIHCUS/CMCO,GYNECOLOGIE ET OBSTETRIQUE - CMCO,0,0,0,0,0,0,0
31/08/2013,CCOM,CCOM Chirurgie,0,1,18,19,1,0,0
31/08/2013,CH Altkirch,Upatou,1,6,36,43,5,0,1
31/08/2013,CH de Colmar (CMC Le Parc),SAU Le Parc,6,0,40,46,3,0,0
31/08/2013,CH de Colmar (Louis Pasteur),SAU Pasteur,0,23,100,123,26,9,3
31/08/2013,CH de Guebwiller,UHTCD,0,4,43,47,1,2,3
31/08/2013,CH de Mulhouse ( Hasenrain),PEDIATRIE NEONATOLOGIE,9,0,15,24,0,0,0
31/08/2013,CH de Mulhouse (Emile Muller-Moenschberg,URGENCES,0,17,120,137,13,18,6
31/08/2013,CH de Saverne,PEDIATRIE,6,0,23,29,6,0,0
31/08/2013,CH de Saverne,S.A.U. (ADULTES),0,15,29,44,8,5,2
31/08/2013,CH de Thann,Urgences,0,5,35,40,3,2,0
31/08/2013,CH de Wissembourg,Urgences ,0,5,29,34,10,0,1
31/08/2013,CHU de Strasbourg (Hôp. Civil),Urgences Médico-Chirurgicales NHC,0,21,85,106,39,3,0
31/08/2013,CHU de Strasbourg(Hautepierre),Urgences chirurgicales pédiatriques,12,0,31,43,3,3,0
31/08/2013,CHU de Strasbourg(Hautepierre),Gynéco-Obstétrique (HTP),1,0,28,29,11,0,0
31/08/2013,CHU de Strasbourg(Hautepierre),Urgences Adulte HTP,0,18,95,113,30,0,0
31/08/2013,CHU de Strasbourg(Hautepierre),Urgences chirurgicales pédiatriques,3,0,39,42,7,7,0
31/08/2013,Clinique des 3 Frontières,UPATOU (Structure des urgences),0,6,48,54,5,0,1
31/08/2013,Clinique Ste Odile (Strasbourg,UPATOU,0,5,68,73,1,4,1
31/08/2013,CMCO,GYNECO-OBSTETRIQUE,0,0,0,0,0,0,0
31/08/2013,SIHCUS/CMCO,GYNECOLOGIE ET OBSTETRIQUE - CMCO,0,0,0,0,0,0,0
30/08/2013,CCOM,CCOM Chirurgie,0,2,21,23,0,0,0
30/08/2013,CH Altkirch,Upatou,0,7,36,43,4,0,2
30/08/2013,CH de Colmar (CMC Le Parc),SAU Le Parc,8,0,23,31,1,0,0
30/08/2013,CH de Colmar (Louis Pasteur),SAU Pasteur,0,14,112,126,22,7,3
30/08/2013,CH de Guebwiller,UHTCD,0,1,1,2,2,0,1
30/08/2013,CH de Mulhouse ( Hasenrain),PEDIATRIE NEONATOLOGIE,16,0,18,34,6,2,0
30/08/2013,CH de Mulhouse (Emile Muller-Moenschberg,URGENCES,2,21,113,136,22,10,4
30/08/2013,CH de Saverne,PEDIATRIE,1,0,12,13,0,0,0
30/08/2013,CH de Saverne,S.A.U. (ADULTES),0,14,34,48,10,3,1
30/08/2013,CH de Thann,Urgences,0,5,34,39,1,2,4
30/08/2013,CH de Wissembourg,Urgences ,0,9,18,27,8,0,0
30/08/2013,CHU de Strasbourg (Hôp. Civil),Urgences Médico-Chirurgicales NHC,0,21,67,88,51,5,0
30/08/2013,CHU de Strasbourg(Hautepierre),Urgences chirurgicales pédiatriques,9,0,15,24,4,4,0
30/08/2013,CHU de Strasbourg(Hautepierre),Gynéco-Obstétrique (HTP),3,0,19,22,10,0,0
30/08/2013,CHU de Strasbourg(Hautepierre),Urgences Adulte HTP,0,21,64,85,41,0,0
30/08/2013,CHU de Strasbourg(Hautepierre),Urgences chirurgicales pédiatriques,2,0,42,44,3,3,0
30/08/2013,Clinique des 3 Frontières,UPATOU (Structure des urgences),0,3,40,43,2,0,0
30/08/2013,Clinique Ste Odile (Strasbourg,UPATOU,0,7,43,50,4,6,1
30/08/2013,CMCO,GYNECO-OBSTETRIQUE,0,0,0,0,0,0,0
30/08/2013,SIHCUS/CMCO,GYNECOLOGIE ET OBSTETRIQUE - CMCO,0,0,0,0,0,0,0
29/08/2013,CCOM,CCOM Chirurgie,0,2,14,16,1,0,0
29/08/2013,CH Altkirch,Upatou,0,10,23,33,7,1,0
29/08/2013,CH de Colmar (CMC Le Parc),SAU Le Parc,8,0,32,40,5,0,0
29/08/2013,CH de Colmar (Louis Pasteur),SAU Pasteur,0,20,108,128,25,15,1
29/08/2013,CH de Guebwiller,UHTCD,0,8,24,32,2,0,0
29/08/2013,CH de Mulhouse ( Hasenrain),PEDIATRIE NEONATOLOGIE,8,0,20,28,2,1,1
29/08/2013,CH de Mulhouse (Emile Muller-Moenschberg,URGENCES,0,24,91,115,17,11,4
29/08/2013,CH de Saverne,PEDIATRIE,2,0,10,12,0,0,0
29/08/2013,CH de Saverne,S.A.U. (ADULTES),0,6,44,50,7,3,0
29/08/2013,CH de Thann,Urgences,2,11,36,49,3,1,4
29/08/2013,CH de Wissembourg,Urgences ,1,6,32,39,10,1,0
29/08/2013,CHU de Strasbourg (Hôp. Civil),Urgences Médico-Chirurgicales NHC,0,17,60,77,35,0,2
29/08/2013,CHU de Strasbourg(Hautepierre),Urgences chirurgicales pédiatriques,1,0,43,44,3,3,0
29/08/2013,CHU de Strasbourg(Hautepierre),Urgences Adulte HTP,0,16,69,85,38,0,0
29/08/2013,CHU de Strasbourg(Hautepierre),Urgences chirurgicales pédiatriques,8,0,26,34,5,5,0
29/08/2013,CHU de Strasbourg(Hautepierre),Gynéco-Obstétrique (HTP),0,0,19,19,8,0,0
29/08/2013,Clinique des 3 Frontières,UPATOU (Structure des urgences),1,3,33,37,3,0,0
29/08/2013,Clinique Ste Odile (Strasbourg,UPATOU,0,5,53,58,2,4,0
29/08/2013,CMCO,GYNECO-OBSTETRIQUE,0,0,0,0,0,0,0
29/08/2013,SIHCUS/CMCO,GYNECOLOGIE ET OBSTETRIQUE - CMCO,0,0,0,0,0,0,0
28/08/2013,CCOM,CCOM Chirurgie,0,1,12,13,0,0,0
28/08/2013,CH Altkirch,Upatou,0,5,34,39,4,0,0
28/08/2013,CH de Colmar (CMC Le Parc),SAU Le Parc,2,0,36,38,11,0,0
28/08/2013,CH de Colmar (Louis Pasteur),SAU Pasteur,0,28,101,129,18,19,1
28/08/2013,CH de Guebwiller,UHTCD,1,4,30,35,1,2,1
28/08/2013,CH de Mulhouse ( Hasenrain),PEDIATRIE NEONATOLOGIE,8,0,12,20,2,1,0
28/08/2013,CH de Mulhouse (Emile Muller-Moenschberg,URGENCES,0,13,101,114,4,12,1
28/08/2013,CH de Saverne,PEDIATRIE,0,0,12,12,2,0,0
28/08/2013,CH de Saverne,S.A.U. (ADULTES),0,10,31,41,9,4,1
28/08/2013,CH de Thann,Urgences,1,6,31,38,3,1,1
28/08/2013,CH de Wissembourg,Urgences ,0,3,36,39,10,1,0
28/08/2013,CHU de Strasbourg (Hôp. Civil),Urgences Médico-Chirurgicales NHC,0,16,56,72,33,3,1
28/08/2013,CHU de Strasbourg(Hautepierre),Urgences chirurgicales pédiatriques,11,0,30,41,4,4,0
28/08/2013,CHU de Strasbourg(Hautepierre),Gynéco-Obstétrique (HTP),0,0,21,21,11,0,0
28/08/2013,CHU de Strasbourg(Hautepierre),Urgences Adulte HTP,0,11,51,62,19,0,0
28/08/2013,CHU de Strasbourg(Hautepierre),Urgences chirurgicales pédiatriques,3,0,40,43,3,2,0
28/08/2013,Clinique des 3 Frontières,UPATOU (Structure des urgences),0,6,33,39,7,0,0
28/08/2013,Clinique Ste Odile (Strasbourg,UPATOU,0,3,36,39,3,3,3
28/08/2013,CMCO,GYNECO-OBSTETRIQUE,0,0,0,0,0,0,0
28/08/2013,SIHCUS/CMCO,GYNECOLOGIE ET OBSTETRIQUE - CMCO,0,0,0,0,0,0,0
27/08/2013,CCOM,CCOM Chirurgie,0,0,19,19,2,0,0
27/08/2013,CH Altkirch,Upatou,0,4,38,42,8,0,0
27/08/2013,CH de Colmar (CMC Le Parc),SAU Le Parc,4,0,22,26,8,0,0
27/08/2013,CH de Colmar (Louis Pasteur),SAU Pasteur,0,27,90,117,24,8,0
27/08/2013,CH de Guebwiller,UHTCD,0,7,39,46,3,3,1
27/08/2013,CH de Mulhouse ( Hasenrain),PEDIATRIE NEONATOLOGIE,12,0,11,23,2,2,0
27/08/2013,CH de Mulhouse (Emile Muller-Moenschberg,URGENCES,1,22,84,107,12,11,3
27/08/2013,CH de Saverne,PEDIATRIE,3,0,16,19,4,2,0
27/08/2013,CH de Saverne,S.A.U. (ADULTES),0,11,28,39,15,2,0
27/08/2013,CH de Thann,Urgences,0,6,30,36,3,2,1
27/08/2013,CH de Wissembourg,Urgences ,0,3,20,23,6,1,1
27/08/2013,CHU de Strasbourg (Hôp. Civil),Urgences Médico-Chirurgicales NHC,0,12,60,72,32,11,2
27/08/2013,CHU de Strasbourg(Hautepierre),Urgences Adulte HTP,0,15,63,78,31,0,1
27/08/2013,CHU de Strasbourg(Hautepierre),Urgences chirurgicales pédiatriques,6,0,35,41,3,3,0
27/08/2013,CHU de Strasbourg(Hautepierre),Urgences chirurgicales pédiatriques,11,0,20,31,4,4,0
27/08/2013,CHU de Strasbourg(Hautepierre),Gynéco-Obstétrique (HTP),0,0,27,27,12,0,0
27/08/2013,Clinique des 3 Frontières,UPATOU (Structure des urgences),0,5,33,38,4,0,0
27/08/2013,Clinique Ste Odile (Strasbourg,UPATOU,1,4,56,61,3,7,1
27/08/2013,CMCO,GYNECO-OBSTETRIQUE,0,0,0,0,0,0,0
27/08/2013,SIHCUS/CMCO,GYNECOLOGIE ET OBSTETRIQUE - CMCO,0,0,0,0,0,0,0
26/08/2013,CCOM,CCOM Chirurgie,0,2,21,23,0,0,0
26/08/2013,CH Altkirch,Upatou,0,8,37,45,8,2,3
26/08/2013,CH de Colmar (CMC Le Parc),SAU Le Parc,4,0,36,40,6,0,0
26/08/2013,CH de Colmar (Louis Pasteur),SAU Pasteur,0,17,119,136,15,10,0
26/08/2013,CH de Guebwiller,UHTCD,0,4,36,40,0,1,0
26/08/2013,CH de Mulhouse ( Hasenrain),PEDIATRIE NEONATOLOGIE,12,0,14,26,2,3,0
26/08/2013,CH de Mulhouse (Emile Muller-Moenschberg,URGENCES,0,17,116,133,15,9,3
26/08/2013,CH de Saverne,PEDIATRIE,2,0,20,22,3,0,0
26/08/2013,CH de Saverne,S.A.U. (ADULTES),0,13,40,53,12,4,0
26/08/2013,CH de Wissembourg,Urgences ,0,9,26,35,4,0,1
26/08/2013,CHU de Strasbourg (Hôp. Civil),Urgences Médico-Chirurgicales NHC,1,19,61,81,41,9,0
26/08/2013,CHU de Strasbourg(Hautepierre),Urgences chirurgicales pédiatriques,2,0,29,31,4,4,0
26/08/2013,CHU de Strasbourg(Hautepierre),Urgences chirurgicales pédiatriques,10,0,24,34,7,7,0
26/08/2013,CHU de Strasbourg(Hautepierre),Gynéco-Obstétrique (HTP),1,0,28,29,16,0,0
26/08/2013,CHU de Strasbourg(Hautepierre),Urgences Adulte HTP,0,23,60,83,42,0,0
26/08/2013,Clinique des 3 Frontières,UPATOU (Structure des urgences),0,4,43,47,7,0,3
26/08/2013,Clinique Ste Odile (Strasbourg,UPATOU,0,9,69,78,1,10,1
26/08/2013,CMCO,GYNECO-OBSTETRIQUE,0,0,0,0,0,0,0
26/08/2013,SIHCUS/CMCO,GYNECOLOGIE ET OBSTETRIQUE - CMCO,0,0,0,0,0,0,0
25/08/2013,CCOM,CCOM Chirurgie,0,0,15,15,1,0,0
25/08/2013,CH Altkirch,Upatou,0,9,23,32,2,0,1
25/08/2013,CH de Colmar (CMC Le Parc),SAU Le Parc,9,0,39,48,2,0,0
25/08/2013,CH de Colmar (Louis Pasteur),SAU Pasteur,0,10,102,112,24,8,1
25/08/2013,CH de Guebwiller,UHTCD,0,3,35,38,0,3,3
25/08/2013,CH de Mulhouse ( Hasenrain),PEDIATRIE NEONATOLOGIE,8,0,15,23,6,1,0
25/08/2013,CH de Mulhouse (Emile Muller-Moenschberg,URGENCES,2,19,112,133,15,11,1
25/08/2013,CH de Saverne,S.A.U. (ADULTES),0,7,33,40,7,3,1
25/08/2013,CH de Saverne,PEDIATRIE,2,0,10,12,1,0,0
25/08/2013,CH de Thann,Urgences,0,4,40,44,2,1,2
25/08/2013,CH de Wissembourg,Urgences ,0,4,35,39,5,0,0
25/08/2013,CHU de Strasbourg (Hôp. Civil),Urgences Médico-Chirurgicales NHC,0,11,74,85,26,2,0
25/08/2013,CHU de Strasbourg(Hautepierre),Urgences chirurgicales pédiatriques,10,0,50,60,8,8,0
25/08/2013,CHU de Strasbourg(Hautepierre),Gynéco-Obstétrique (HTP),1,0,22,23,8,0,0
25/08/2013,CHU de Strasbourg(Hautepierre),Urgences chirurgicales pédiatriques,2,0,21,23,2,1,0
25/08/2013,CHU de Strasbourg(Hautepierre),Urgences Adulte HTP,0,15,89,104,30,0,0
25/08/2013,Clinique des 3 Frontières,UPATOU (Structure des urgences),0,7,50,57,6,1,1
25/08/2013,Clinique Ste Odile (Strasbourg,UPATOU,0,6,65,71,1,6,2
25/08/2013,CMCO,GYNECO-OBSTETRIQUE,0,0,0,0,0,0,0
25/08/2013,SIHCUS/CMCO,GYNECOLOGIE ET OBSTETRIQUE - CMCO,0,0,0,0,0,0,0
24/08/2013,CCOM,CCOM Chirurgie,0,0,20,20,2,0,0
24/08/2013,CH Altkirch,Upatou,0,8,35,43,6,0,3
24/08/2013,CH de Colmar (CMC Le Parc),SAU Le Parc,3,0,28,31,5,0,0
24/08/2013,CH de Colmar (Louis Pasteur),SAU Pasteur,0,22,92,114,27,11,6
24/08/2013,CH de Guebwiller,UHTCD,0,7,31,38,4,4,2
24/08/2013,CH de Mulhouse ( Hasenrain),PEDIATRIE NEONATOLOGIE,11,0,20,31,3,0,0
24/08/2013,CH de Mulhouse (Emile Muller-Moenschberg,URGENCES,2,22,107,131,15,9,4
24/08/2013,CH de Saverne,S.A.U. (ADULTES),0,12,45,57,5,3,0
24/08/2013,CH de Saverne,PEDIATRIE,4,0,9,13,1,0,0
24/08/2013,CH de Thann,Urgences,0,2,36,38,1,4,1
24/08/2013,CH de Wissembourg,Urgences ,1,6,35,42,6,0,2
24/08/2013,CHU de Strasbourg (Hôp. Civil),Urgences Médico-Chirurgicales NHC,0,23,72,95,43,2,0
24/08/2013,CHU de Strasbourg(Hautepierre),Urgences chirurgicales pédiatriques,9,0,38,47,4,4,0
24/08/2013,CHU de Strasbourg(Hautepierre),Gynéco-Obstétrique (HTP),0,0,32,32,10,0,0
24/08/2013,CHU de Strasbourg(Hautepierre),Urgences Adulte HTP,0,13,67,80,27,0,0
24/08/2013,CHU de Strasbourg(Hautepierre),Urgences chirurgicales pédiatriques,2,0,36,38,3,3,0
24/08/2013,Clinique des 3 Frontières,UPATOU (Structure des urgences),0,1,38,39,4,0,2
24/08/2013,Clinique des Diaconesses,SOS Main,0,2,21,23,4,0,0
24/08/2013,Clinique Ste Odile (Strasbourg,UPATOU,0,5,79,84,0,8,1
24/08/2013,CMCO,GYNECO-OBSTETRIQUE,0,0,0,0,0,0,0
24/08/2013,SIHCUS/CMCO,GYNECOLOGIE ET OBSTETRIQUE - CMCO,0,0,0,0,0,0,0
23/08/2013,CCOM,CCOM Chirurgie,0,0,26,26,1,0,0
23/08/2013,CH Altkirch,Upatou,0,9,37,46,5,4,2
23/08/2013,CH de Colmar (CMC Le Parc),SAU Le Parc,3,0,28,31,5,0,0
23/08/2013,CH de Colmar (Louis Pasteur),SAU Pasteur,0,22,92,114,27,11,6
23/08/2013,CH de Guebwiller,UHTCD,1,4,37,42,1,1,2
23/08/2013,CH de Mulhouse ( Hasenrain),PEDIATRIE NEONATOLOGIE,8,0,22,30,11,1,0
23/08/2013,CH de Mulhouse (Emile Muller-Moenschberg,URGENCES,3,21,116,140,15,10,4
23/08/2013,CH de Saverne,PEDIATRIE,2,0,14,16,1,1,1
23/08/2013,CH de Saverne,S.A.U. (ADULTES),0,10,32,42,9,5,0
23/08/2013,CH de Thann,Urgences,1,3,41,45,2,0,0
23/08/2013,CH de Wissembourg,Urgences ,0,7,23,30,4,0,0
23/08/2013,CHU de Strasbourg (Hôp. Civil),Urgences Médico-Chirurgicales NHC,0,14,78,92,49,5,1
23/08/2013,CHU de Strasbourg(Hautepierre),Gynéco-Obstétrique (HTP),0,0,27,27,17,0,0
23/08/2013,CHU de Strasbourg(Hautepierre),Urgences Adulte HTP,0,18,60,78,32,0,0
23/08/2013,CHU de Strasbourg(Hautepierre),Urgences chirurgicales pédiatriques,5,0,28,33,4,4,0
23/08/2013,CHU de Strasbourg(Hautepierre),Urgences chirurgicales pédiatriques,9,0,26,35,6,6,0
23/08/2013,Clinique des 3 Frontières,UPATOU (Structure des urgences),0,6,40,46,7,0,0
23/08/2013,Clinique des Diaconesses,SOS Main,0,3,36,39,1,1,0
23/08/2013,Clinique Ste Odile (Strasbourg,UPATOU,1,6,61,68,3,4,3
23/08/2013,CMCO,GYNECO-OBSTETRIQUE,0,0,0,0,0,0,0
23/08/2013,SIHCUS/CMCO,GYNECOLOGIE ET OBSTETRIQUE - CMCO,0,0,0,0,0,0,0
22/08/2013,CCOM,CCOM Chirurgie,0,0,26,26,3,0,0
22/08/2013,CH Altkirch,Upatou,0,5,33,38,4,0,1
22/08/2013,CH de Colmar (CMC Le Parc),SAU Le Parc,3,0,25,28,7,0,0
22/08/2013,CH de Colmar (Louis Pasteur),SAU Pasteur,0,22,87,109,18,12,1
22/08/2013,CH de Guebwiller,UHTCD,0,3,36,39,0,2,1
22/08/2013,CH de Mulhouse ( Hasenrain),PEDIATRIE NEONATOLOGIE,7,0,25,32,3,1,0
22/08/2013,CH de Mulhouse (Emile Muller-Moenschberg,URGENCES,2,18,102,122,17,12,4
22/08/2013,CH de Saverne,PEDIATRIE,1,0,10,11,0,0,0
22/08/2013,CH de Saverne,S.A.U. (ADULTES),0,12,37,49,9,2,0
22/08/2013,CH de Wissembourg,Urgences ,1,7,19,27,8,0,2
22/08/2013,CHU de Strasbourg (Hôp. Civil),Urgences Médico-Chirurgicales NHC,0,12,75,87,41,7,3
22/08/2013,CHU de Strasbourg(Hautepierre),Urgences chirurgicales pédiatriques,6,0,25,31,5,5,0
22/08/2013,CHU de Strasbourg(Hautepierre),Gynéco-Obstétrique (HTP),1,0,17,18,6,0,0
22/08/2013,CHU de Strasbourg(Hautepierre),Urgences Adulte HTP,0,18,64,82,42,0,4
22/08/2013,CHU de Strasbourg(Hautepierre),Urgences chirurgicales pédiatriques,1,0,31,32,2,2,0
22/08/2013,Clinique des 3 Frontières,UPATOU (Structure des urgences),2,2,27,31,1,0,0
22/08/2013,Clinique Ste Odile (Strasbourg,UPATOU,1,1,53,55,1,6,3
22/08/2013,CMCO,GYNECO-OBSTETRIQUE,0,0,0,0,0,0,0
22/08/2013,SIHCUS/CMCO,GYNECOLOGIE ET OBSTETRIQUE - CMCO,0,0,0,0,0,0,0
21/08/2013,CCOM,CCOM Chirurgie,0,1,31,32,2,0,0
21/08/2013,CH Altkirch,Upatou,0,3,20,23,3,1,1
21/08/2013,CH de Colmar (CMC Le Parc),SAU Le Parc,2,0,34,36,6,0,1
21/08/2013,CH de Colmar (Louis Pasteur),SAU Pasteur,0,30,93,123,24,10,0
21/08/2013,CH de Guebwiller,UHTCD,0,7,33,40,0,4,2
21/08/2013,CH de Mulhouse ( Hasenrain),PEDIATRIE NEONATOLOGIE,15,0,15,30,3,2,0
21/08/2013,CH de Mulhouse (Emile Muller-Moenschberg,URGENCES,0,20,98,118,13,9,5
21/08/2013,CH de Saverne,S.A.U. (ADULTES),0,8,42,50,10,3,0
21/08/2013,CH de Saverne,PEDIATRIE,2,0,11,13,1,0,0
21/08/2013,CH de Thann,Urgences,0,6,28,34,2,1,0
21/08/2013,CH de Wissembourg,Urgences ,0,9,29,38,6,0,0
21/08/2013,CHU de Strasbourg (Hôp. Civil),Urgences Médico-Chirurgicales NHC,0,19,43,62,32,6,0
21/08/2013,CHU de Strasbourg(Hautepierre),Urgences chirurgicales pédiatriques,9,0,19,28,5,5,0
21/08/2013,CHU de Strasbourg(Hautepierre),Gynéco-Obstétrique (HTP),0,0,16,16,8,0,0
21/08/2013,CHU de Strasbourg(Hautepierre),Urgences chirurgicales pédiatriques,4,0,38,42,5,5,0
21/08/2013,CHU de Strasbourg(Hautepierre),Urgences Adulte HTP,0,21,60,81,38,0,0
21/08/2013,Clinique Ste Odile (Strasbourg,UPATOU,0,9,54,63,3,8,0
21/08/2013,CMCO,GYNECO-OBSTETRIQUE,0,0,0,0,0,0,0
21/08/2013,SIHCUS/CMCO,GYNECOLOGIE ET OBSTETRIQUE - CMCO,0,0,0,0,0,0,0
20/08/2013,CCOM,CCOM Chirurgie,0,3,34,37,2,0,0
20/08/2013,CH Altkirch,Upatou,0,6,41,47,5,1,1
20/08/2013,CH de Colmar (CMC Le Parc),SAU Le Parc,5,0,35,40,2,0,0
20/08/2013,CH de Colmar (Louis Pasteur),SAU Pasteur,0,35,104,139,31,11,0
20/08/2013,CH de Guebwiller,UHTCD,0,5,32,37,3,2,1
20/08/2013,CH de Mulhouse ( Hasenrain),PEDIATRIE NEONATOLOGIE,9,0,15,24,3,1,0
20/08/2013,CH de Mulhouse (Emile Muller-Moenschberg,URGENCES,0,26,110,136,12,12,6
20/08/2013,CH de Saverne,S.A.U. (ADULTES),0,10,41,51,8,2,1
20/08/2013,CH de Saverne,PEDIATRIE,2,0,11,13,2,0,0
20/08/2013,CH de Thann,Urgences,0,3,38,41,2,1,0
20/08/2013,CH de Wissembourg,Urgences ,0,11,20,31,9,0,0
20/08/2013,CHU de Strasbourg (Hôp. Civil),Urgences Médico-Chirurgicales NHC,0,21,58,79,45,4,0
20/08/2013,CHU de Strasbourg(Hautepierre),Urgences chirurgicales pédiatriques,1,0,36,37,4,3,0
20/08/2013,CHU de Strasbourg(Hautepierre),Urgences Adulte HTP,0,17,58,75,29,0,1
20/08/2013,CHU de Strasbourg(Hautepierre),Urgences chirurgicales pédiatriques,3,0,35,38,6,6,0
20/08/2013,CHU de Strasbourg(Hautepierre),Gynéco-Obstétrique (HTP),0,1,24,25,11,0,1
20/08/2013,Clinique des 3 Frontières,UPATOU (Structure des urgences),0,3,43,46,5,1,1
20/08/2013,Clinique Ste Odile (Strasbourg,UPATOU,0,6,60,66,1,5,1
20/08/2013,CMCO,GYNECO-OBSTETRIQUE,0,0,0,0,0,0,0
20/08/2013,SIHCUS/CMCO,GYNECOLOGIE ET OBSTETRIQUE - CMCO,0,0,0,0,0,0,0
19/08/2013,CCOM,CCOM Chirurgie,0,0,36,36,3,0,0
19/08/2013,CH Altkirch,Upatou,1,6,34,41,4,1,0
19/08/2013,CH de Colmar (CMC Le Parc),SAU Le Parc,3,0,38,41,8,0,0
19/08/2013,CH de Colmar (Louis Pasteur),SAU Pasteur,0,26,125,151,16,14,0
19/08/2013,CH de Guebwiller,UHTCD,0,7,32,39,2,2,1
19/08/2013,CH de Mulhouse ( Hasenrain),PEDIATRIE NEONATOLOGIE,11,0,22,33,1,1,0
19/08/2013,CH de Mulhouse (Emile Muller-Moenschberg,URGENCES,0,27,106,133,25,12,4
19/08/2013,CH de Saverne,S.A.U. (ADULTES),0,11,37,48,11,3,0
19/08/2013,CH de Saverne,PEDIATRIE,3,0,17,20,1,2,0
19/08/2013,CH de Thann,Urgences,0,6,42,48,6,2,1
19/08/2013,CH de Wissembourg,Urgences ,1,5,29,35,5,0,1
19/08/2013,CHU de Strasbourg (Hôp. Civil),Urgences Médico-Chirurgicales NHC,0,22,69,91,47,2,1
19/08/2013,CHU de Strasbourg(Hautepierre),Urgences chirurgicales pédiatriques,4,0,30,34,3,3,0
19/08/2013,CHU de Strasbourg(Hautepierre),Urgences Adulte HTP,0,14,58,72,31,0,0
19/08/2013,CHU de Strasbourg(Hautepierre),Urgences chirurgicales pédiatriques,11,0,16,27,2,2,0
19/08/2013,CHU de Strasbourg(Hautepierre),Gynéco-Obstétrique (HTP),0,0,26,26,9,0,0
19/08/2013,Clinique des 3 Frontières,UPATOU (Structure des urgences),0,7,35,42,4,0,2
19/08/2013,Clinique Ste Odile (Strasbourg,UPATOU,0,4,53,57,1,5,3
19/08/2013,CMCO,GYNECO-OBSTETRIQUE,0,0,0,0,0,0,0
19/08/2013,SIHCUS/CMCO,GYNECOLOGIE ET OBSTETRIQUE - CMCO,0,0,0,0,0,0,0
18/08/2013,CCOM,CCOM Chirurgie,0,0,15,15,1,0,0
18/08/2013,CH Altkirch,Upatou,0,5,38,43,6,1,2
18/08/2013,CH de Colmar (CMC Le Parc),SAU Le Parc,4,0,41,45,6,0,0
18/08/2013,CH de Colmar (Louis Pasteur),SAU Pasteur,0,26,98,124,20,9,0
18/08/2013,CH de Guebwiller,UHTCD,0,2,38,40,1,2,0
18/08/2013,CH de Mulhouse ( Hasenrain),PEDIATRIE NEONATOLOGIE,8,0,23,31,5,0,0
18/08/2013,CH de Mulhouse (Emile Muller-Moenschberg,URGENCES,0,24,117,141,9,16,0
18/08/2013,CH de Saverne,PEDIATRIE,1,0,12,13,2,0,0
18/08/2013,CH de Saverne,S.A.U. (ADULTES),0,5,37,42,5,3,0
18/08/2013,CH de Wissembourg,Urgences ,1,3,24,28,3,9,0
18/08/2013,CHU de Strasbourg (Hôp. Civil),Urgences Médico-Chirurgicales NHC,0,22,65,87,27,1,2
18/08/2013,CHU de Strasbourg(Hautepierre),Urgences chirurgicales pédiatriques,2,0,32,34,3,3,0
18/08/2013,CHU de Strasbourg(Hautepierre),Urgences chirurgicales pédiatriques,15,0,33,48,6,6,0
18/08/2013,CHU de Strasbourg(Hautepierre),Gynéco-Obstétrique (HTP),0,0,37,37,16,0,0
18/08/2013,CHU de Strasbourg(Hautepierre),Urgences Adulte HTP,0,19,74,93,31,0,0
18/08/2013,Clinique des 3 Frontières,UPATOU (Structure des urgences),1,2,45,48,4,0,3
18/08/2013,Clinique Ste Odile (Strasbourg,UPATOU,0,6,78,84,2,7,2
18/08/2013,CMCO,GYNECO-OBSTETRIQUE,0,0,0,0,0,0,0
18/08/2013,SIHCUS/CMCO,GYNECOLOGIE ET OBSTETRIQUE - CMCO,0,0,0,0,0,0,0
17/08/2013,CCOM,CCOM Chirurgie,0,0,12,12,0,0,0
17/08/2013,CH Altkirch,Upatou,0,9,30,39,9,2,0
17/08/2013,CH de Colmar (CMC Le Parc),SAU Le Parc,9,0,34,43,6,0,0
17/08/2013,CH de Colmar (Louis Pasteur),SAU Pasteur,0,23,122,145,28,10,5
17/08/2013,CH de Guebwiller,UHTCD,0,7,50,57,3,6,6
17/08/2013,CH de Mulhouse ( Hasenrain),PEDIATRIE NEONATOLOGIE,11,0,19,30,5,0,0
17/08/2013,CH de Mulhouse (Emile Muller-Moenschberg,URGENCES,3,22,113,138,13,16,5
17/08/2013,CH de Saverne,S.A.U. (ADULTES),0,9,44,53,9,0,0
17/08/2013,CH de Saverne,PEDIATRIE,3,0,16,19,1,0,0
17/08/2013,CH de Wissembourg,Urgences ,0,6,29,35,7,0,0
17/08/2013,CHU de Strasbourg (Hôp. Civil),Urgences Médico-Chirurgicales NHC,0,17,91,108,40,2,0
17/08/2013,CHU de Strasbourg(Hautepierre),Urgences chirurgicales pédiatriques,13,0,23,36,3,3,0
17/08/2013,CHU de Strasbourg(Hautepierre),Gynéco-Obstétrique (HTP),0,0,35,35,12,0,0
17/08/2013,CHU de Strasbourg(Hautepierre),Urgences Adulte HTP,0,11,75,86,34,0,1
17/08/2013,CHU de Strasbourg(Hautepierre),Urgences chirurgicales pédiatriques,1,0,41,42,4,4,0
17/08/2013,Clinique des 3 Frontières,UPATOU (Structure des urgences),0,7,43,50,6,0,0
17/08/2013,Clinique Ste Odile (Strasbourg,UPATOU,2,1,62,65,1,7,1
17/08/2013,CMCO,GYNECO-OBSTETRIQUE,0,0,0,0,0,0,0
17/08/2013,SIHCUS/CMCO,GYNECOLOGIE ET OBSTETRIQUE - CMCO,0,0,0,0,0,0,0
16/08/2013,CCOM,CCOM Chirurgie,0,0,22,22,1,0,0
16/08/2013,CH Altkirch,Upatou,0,4,36,40,4,1,2
16/08/2013,CH de Colmar (CMC Le Parc),SAU Le Parc,6,0,40,46,9,0,2
16/08/2013,CH de Colmar (Louis Pasteur),SAU Pasteur,1,23,126,150,27,10,1
16/08/2013,CH de Guebwiller,UHTCD,0,6,39,45,3,0,5
16/08/2013,CH de Mulhouse ( Hasenrain),PEDIATRIE NEONATOLOGIE,17,0,21,38,3,1,0
16/08/2013,CH de Mulhouse (Emile Muller-Moenschberg,URGENCES,0,25,146,171,22,5,2
16/08/2013,CH de Saverne,S.A.U. (ADULTES),0,12,45,57,11,2,1
16/08/2013,CH de Saverne,PEDIATRIE,4,0,17,21,1,1,0
16/08/2013,CH de Wissembourg,Urgences ,0,6,25,31,8,0,0
16/08/2013,CHU de Strasbourg (Hôp. Civil),Urgences Médico-Chirurgicales NHC,0,20,66,86,48,6,2
16/08/2013,CHU de Strasbourg(Hautepierre),Urgences chirurgicales pédiatriques,5,0,33,38,7,7,0
16/08/2013,CHU de Strasbourg(Hautepierre),Urgences chirurgicales pédiatriques,9,0,31,40,4,3,0
16/08/2013,CHU de Strasbourg(Hautepierre),Gynéco-Obstétrique (HTP),1,0,32,33,8,0,0
16/08/2013,CHU de Strasbourg(Hautepierre),Urgences Adulte HTP,0,16,68,84,29,0,1
16/08/2013,Clinique des 3 Frontières,UPATOU (Structure des urgences),0,7,48,55,11,0,0
16/08/2013,Clinique des Diaconesses,SOS Main,0,3,27,30,2,0,0
16/08/2013,Clinique Ste Odile (Strasbourg,UPATOU,0,4,78,82,4,9,3
16/08/2013,CMCO,GYNECO-OBSTETRIQUE,0,0,0,0,0,0,0
16/08/2013,SIHCUS/CMCO,GYNECOLOGIE ET OBSTETRIQUE - CMCO,0,0,0,0,0,0,0
15/08/2013,CCOM,CCOM Chirurgie,0,1,10,11,1,0,0
15/08/2013,CH Altkirch,Upatou,0,3,34,37,3,2,1
15/08/2013,CH de Colmar (CMC Le Parc),SAU Le Parc,4,0,43,47,2,0,0
15/08/2013,CH de Colmar (Louis Pasteur),SAU Pasteur,0,20,116,136,23,8,0
15/08/2013,CH de Guebwiller,UHTCD,0,3,46,49,0,0,2
15/08/2013,CH de Mulhouse ( Hasenrain),PEDIATRIE NEONATOLOGIE,10,0,10,20,2,0,0
15/08/2013,CH de Mulhouse (Emile Muller-Moenschberg,URGENCES,0,22,105,127,19,14,1
15/08/2013,CH de Saverne,S.A.U. (ADULTES),0,6,43,49,6,2,1
15/08/2013,CH de Saverne,PEDIATRIE,2,0,15,17,1,0,0
15/08/2013,CH de Thann,Urgences,0,7,43,50,3,2,4
15/08/2013,CHU de Strasbourg (Hôp. Civil),Urgences Médico-Chirurgicales NHC,0,12,71,83,37,0,1
15/08/2013,CHU de Strasbourg(Hautepierre),Urgences chirurgicales pédiatriques,1,0,29,30,3,3,0
15/08/2013,CHU de Strasbourg(Hautepierre),Urgences Adulte HTP,0,21,59,80,25,0,0
15/08/2013,CHU de Strasbourg(Hautepierre),Urgences chirurgicales pédiatriques,10,0,30,40,5,5,0
15/08/2013,CHU de Strasbourg(Hautepierre),Gynéco-Obstétrique (HTP),0,0,28,28,3,0,0
15/08/2013,Clinique des 3 Frontières,UPATOU (Structure des urgences),2,3,47,52,3,0,0
15/08/2013,Clinique des Diaconesses,SOS Main,0,1,26,27,0,0,0
15/08/2013,Clinique Ste Odile (Strasbourg,UPATOU,1,4,68,73,3,5,2
15/08/2013,CMCO,GYNECO-OBSTETRIQUE,0,0,0,0,0,0,0
15/08/2013,SIHCUS/CMCO,GYNECOLOGIE ET OBSTETRIQUE - CMCO,0,0,0,0,0,0,0
14/08/2013,CCOM,CCOM Chirurgie,0,2,26,28,2,0,0
14/08/2013,CH Altkirch,Upatou,0,8,32,40,4,0,3
14/08/2013,CH de Colmar (CMC Le Parc),SAU Le Parc,4,0,27,31,1,0,0
14/08/2013,CH de Colmar (Louis Pasteur),SAU Pasteur,0,18,113,131,12,20,2
14/08/2013,CH de Guebwiller,UHTCD,0,3,43,46,0,1,0
14/08/2013,CH de Mulhouse ( Hasenrain),PEDIATRIE NEONATOLOGIE,7,0,21,28,0,0,0
14/08/2013,CH de Mulhouse (Emile Muller-Moenschberg,URGENCES,0,34,106,140,19,4,5
14/08/2013,CH de Saverne,PEDIATRIE,4,0,13,17,0,0,0
14/08/2013,CH de Saverne,S.A.U. (ADULTES),0,10,42,52,9,5,1
14/08/2013,CH de Thann,Urgences,0,7,29,36,4,0,2
14/08/2013,CHU de Strasbourg (Hôp. Civil),Urgences Médico-Chirurgicales NHC,0,21,69,90,53,0,0
14/08/2013,CHU de Strasbourg(Hautepierre),Urgences Adulte HTP,0,17,70,87,34,0,0
14/08/2013,CHU de Strasbourg(Hautepierre),Urgences chirurgicales pédiatriques,4,0,31,35,5,5,0
14/08/2013,CHU de Strasbourg(Hautepierre),Urgences chirurgicales pédiatriques,10,0,33,43,6,6,0
14/08/2013,CHU de Strasbourg(Hautepierre),Gynéco-Obstétrique (HTP),0,0,25,25,10,0,0
14/08/2013,Clinique des 3 Frontières,UPATOU (Structure des urgences),1,10,26,37,6,0,1
14/08/2013,Clinique des Diaconesses,SOS Main,0,1,26,27,1,0,0
14/08/2013,Clinique Ste Odile (Strasbourg,UPATOU,0,9,56,65,1,5,2
14/08/2013,CMCO,GYNECO-OBSTETRIQUE,0,0,0,0,0,0,0
14/08/2013,SIHCUS/CMCO,GYNECOLOGIE ET OBSTETRIQUE - CMCO,0,0,0,0,0,0,0
13/08/2013,CCOM,CCOM Chirurgie,0,1,14,15,1,0,0
13/08/2013,CH Altkirch,Upatou,0,3,32,35,5,1,2
13/08/2013,CH de Colmar (CMC Le Parc),SAU Le Parc,7,0,28,35,4,0,0
13/08/2013,CH de Colmar (Louis Pasteur),SAU Pasteur,0,22,119,141,15,16,2
13/08/2013,CH de Guebwiller,UHTCD,0,5,37,42,4,1,1
13/08/2013,CH de Mulhouse ( Hasenrain),PEDIATRIE NEONATOLOGIE,5,0,17,22,4,2,0
13/08/2013,CH de Mulhouse (Emile Muller-Moenschberg,URGENCES,1,21,118,140,12,14,2
13/08/2013,CH de Saverne,S.A.U. (ADULTES),0,7,31,38,11,2,2
13/08/2013,CH de Saverne,PEDIATRIE,3,0,12,15,3,0,0
13/08/2013,CH de Sélestat,Acceuil des urgences,0,10,57,67,12,3,0
13/08/2013,CH de Thann,Urgences,1,8,35,44,3,1,0
13/08/2013,CHU de Strasbourg (Hôp. Civil),Urgences Médico-Chirurgicales NHC,0,20,62,82,43,11,1
13/08/2013,CHU de Strasbourg(Hautepierre),Urgences chirurgicales pédiatriques,2,0,50,52,5,5,0
13/08/2013,CHU de Strasbourg(Hautepierre),Urgences Adulte HTP,2,13,55,70,22,0,0
13/08/2013,CHU de Strasbourg(Hautepierre),Urgences chirurgicales pédiatriques,11,0,20,31,4,4,0
13/08/2013,CHU de Strasbourg(Hautepierre),Gynéco-Obstétrique (HTP),0,1,18,19,9,0,0
13/08/2013,Clinique des 3 Frontières,UPATOU (Structure des urgences),1,5,40,46,7,0,0
13/08/2013,Clinique des Diaconesses,SOS Main,0,1,27,28,0,0,0
13/08/2013,Clinique Ste Odile (Strasbourg,UPATOU,0,5,49,54,3,8,1
13/08/2013,CMCO,GYNECO-OBSTETRIQUE,0,0,0,0,0,0,0
13/08/2013,SIHCUS/CMCO,GYNECOLOGIE ET OBSTETRIQUE - CMCO,0,0,0,0,0,0,0
12/08/2013,CCOM,CCOM Chirurgie,0,3,22,25,0,0,0
12/08/2013,CH de Colmar (CMC Le Parc),SAU Le Parc,11,0,24,35,2,1,0
12/08/2013,CH de Colmar (Louis Pasteur),SAU Pasteur,0,21,127,148,20,9,0
12/08/2013,CH de Guebwiller,UHTCD,0,7,42,49,3,0,1
12/08/2013,CH de Mulhouse ( Hasenrain),PEDIATRIE NEONATOLOGIE,7,0,23,30,2,0,0
12/08/2013,CH de Mulhouse (Emile Muller-Moenschberg,URGENCES,2,34,113,149,17,12,4
12/08/2013,CH de Saverne,S.A.U. (ADULTES),0,7,40,47,7,2,0
12/08/2013,CH de Saverne,PEDIATRIE,5,0,13,18,2,0,0
12/08/2013,CH de Sélestat,Acceuil des urgences,0,17,65,82,15,3,2
12/08/2013,CH de Thann,Urgences,0,9,40,49,3,1,4
12/08/2013,CHU de Strasbourg (Hôp. Civil),Urgences Médico-Chirurgicales NHC,0,14,52,66,38,7,4
12/08/2013,CHU de Strasbourg(Hautepierre),Urgences chirurgicales pédiatriques,6,0,26,32,1,1,0
12/08/2013,CHU de Strasbourg(Hautepierre),Urgences chirurgicales pédiatriques,7,0,29,36,1,1,0
12/08/2013,CHU de Strasbourg(Hautepierre),Gynéco-Obstétrique (HTP),2,0,24,26,8,0,1
12/08/2013,CHU de Strasbourg(Hautepierre),Urgences Adulte HTP,0,20,74,94,38,0,2
12/08/2013,Clinique des 3 Frontières,UPATOU (Structure des urgences),1,4,47,52,8,0,0
12/08/2013,Clinique Ste Odile (Strasbourg,UPATOU,0,8,73,81,1,9,2
12/08/2013,CMCO,GYNECO-OBSTETRIQUE,0,0,0,0,0,0,0
12/08/2013,SIHCUS/CMCO,GYNECOLOGIE ET OBSTETRIQUE - CMCO,0,0,0,0,0,0,0
11/08/2013,CCOM,CCOM Chirurgie,0,1,18,19,3,0,0
11/08/2013,CH Altkirch,Upatou,0,6,30,36,4,0,2
11/08/2013,CH de Colmar (CMC Le Parc),SAU Le Parc,4,0,35,39,1,0,0
11/08/2013,CH de Colmar (Louis Pasteur),SAU Pasteur,0,16,101,117,21,8,0
11/08/2013,CH de Guebwiller,UHTCD,0,3,39,42,1,3,0
11/08/2013,CH de Mulhouse ( Hasenrain),PEDIATRIE NEONATOLOGIE,6,0,26,32,5,1,0
11/08/2013,CH de Mulhouse (Emile Muller-Moenschberg,URGENCES,2,17,145,164,16,9,3
11/08/2013,CH de Saverne,PEDIATRIE,2,0,19,21,2,0,0
11/08/2013,CH de Saverne,S.A.U. (ADULTES),0,6,44,50,6,1,1
11/08/2013,CH de Sélestat,Acceuil des urgences,0,8,80,88,8,7,2
11/08/2013,CH de Wissembourg,Urgences ,3,6,31,40,7,0,1
11/08/2013,CHU de Strasbourg (Hôp. Civil),Urgences Médico-Chirurgicales NHC,1,15,81,97,40,1,0
11/08/2013,CHU de Strasbourg(Hautepierre),Urgences chirurgicales pédiatriques,3,0,23,26,4,4,0
11/08/2013,CHU de Strasbourg(Hautepierre),Urgences chirurgicales pédiatriques,10,0,38,48,3,3,0
11/08/2013,CHU de Strasbourg(Hautepierre),Gynéco-Obstétrique (HTP),0,0,19,19,6,0,0
11/08/2013,CHU de Strasbourg(Hautepierre),Urgences Adulte HTP,1,12,62,75,24,0,0
11/08/2013,Clinique des 3 Frontières,UPATOU (Structure des urgences),1,5,43,49,4,0,1
11/08/2013,Clinique Ste Odile (Strasbourg,UPATOU,0,2,63,65,0,5,2
11/08/2013,CMCO,GYNECO-OBSTETRIQUE,0,0,0,0,0,0,0
11/08/2013,SIHCUS/CMCO,GYNECOLOGIE ET OBSTETRIQUE - CMCO,0,0,0,0,0,0,0
10/08/2013,CCOM,CCOM Chirurgie,0,4,26,30,9,0,0
10/08/2013,CH Altkirch,Upatou,1,5,47,53,2,0,3
10/08/2013,CH de Colmar (CMC Le Parc),SAU Le Parc,4,0,40,44,6,0,0
10/08/2013,CH de Colmar (Louis Pasteur),SAU Pasteur,0,23,112,135,27,8,1
10/08/2013,CH de Guebwiller,UHTCD,0,6,38,44,4,2,1
10/08/2013,CH de Mulhouse ( Hasenrain),PEDIATRIE NEONATOLOGIE,12,0,22,34,4,0,0
10/08/2013,CH de Mulhouse (Emile Muller-Moenschberg,URGENCES,1,28,139,168,14,9,5
10/08/2013,CH de Saverne,S.A.U. (ADULTES),0,9,45,54,7,7,0
10/08/2013,CH de Saverne,PEDIATRIE,4,0,18,22,4,0,0
10/08/2013,CH de Sélestat,Acceuil des urgences,2,15,63,80,15,7,2
10/08/2013,CH de Thann,Urgences,0,3,37,40,1,3,3
10/08/2013,CH de Wissembourg,Urgences ,0,6,37,43,11,0,0
10/08/2013,CHU de Strasbourg (Hôp. Civil),Urgences Médico-Chirurgicales NHC,0,9,75,84,39,3,0
10/08/2013,CHU de Strasbourg(Hautepierre),Urgences chirurgicales pédiatriques,13,0,35,48,9,9,0
10/08/2013,CHU de Strasbourg(Hautepierre),Urgences Adulte HTP,0,12,78,90,32,0,0
10/08/2013,CHU de Strasbourg(Hautepierre),Gynéco-Obstétrique (HTP),0,0,29,29,13,0,0
10/08/2013,CHU de Strasbourg(Hautepierre),Urgences chirurgicales pédiatriques,4,0,35,39,4,3,0
10/08/2013,Clinique des 3 Frontières,UPATOU (Structure des urgences),0,3,32,35,1,0,1
10/08/2013,Clinique Ste Odile (Strasbourg,UPATOU,0,3,76,79,1,6,1
10/08/2013,CMCO,GYNECO-OBSTETRIQUE,0,0,0,0,0,0,0
10/08/2013,SIHCUS/CMCO,GYNECOLOGIE ET OBSTETRIQUE - CMCO,0,0,0,0,0,0,0
9/08/2013,CCOM,CCOM Chirurgie,0,3,30,33,5,0,0
9/08/2013,CH Altkirch,Upatou,0,5,29,34,3,1,1
9/08/2013,CH de Colmar (CMC Le Parc),SAU Le Parc,9,0,33,42,3,0,0
9/08/2013,CH de Colmar (Louis Pasteur),SAU Pasteur,0,34,92,126,20,9,0
9/08/2013,CH de Guebwiller,UHTCD,0,5,30,35,1,1,0
9/08/2013,CH de Mulhouse ( Hasenrain),PEDIATRIE NEONATOLOGIE,9,0,16,25,2,0,0
9/08/2013,CH de Mulhouse (Emile Muller-Moenschberg,URGENCES,1,27,115,143,15,10,2
9/08/2013,CH de Saverne,PEDIATRIE,1,0,14,15,2,0,0
9/08/2013,CH de Saverne,S.A.U. (ADULTES),0,8,52,60,15,2,1
9/08/2013,CH de Sélestat,Acceuil des urgences,1,8,77,86,9,5,0
9/08/2013,CH de Thann,Urgences,0,12,41,53,4,1,1
9/08/2013,CH de Wissembourg,Urgences ,0,8,26,34,11,0,0
9/08/2013,CHU de Strasbourg (Hôp. Civil),Urgences Médico-Chirurgicales NHC,0,21,71,92,48,4,1
9/08/2013,CHU de Strasbourg(Hautepierre),Urgences chirurgicales pédiatriques,12,0,17,29,4,4,0
9/08/2013,CHU de Strasbourg(Hautepierre),Urgences Adulte HTP,0,17,72,89,30,0,0
9/08/2013,CHU de Strasbourg(Hautepierre),Gynéco-Obstétrique (HTP),0,0,29,29,11,0,0
9/08/2013,CHU de Strasbourg(Hautepierre),Urgences chirurgicales pédiatriques,2,0,35,37,3,3,0
9/08/2013,Clinique des 3 Frontières,UPATOU (Structure des urgences),1,9,33,43,6,0,1
9/08/2013,Clinique Ste Odile (Strasbourg,UPATOU,0,2,59,61,3,5,0
9/08/2013,CMCO,GYNECO-OBSTETRIQUE,0,0,0,0,0,0,0
9/08/2013,SIHCUS/CMCO,GYNECOLOGIE ET OBSTETRIQUE - CMCO,0,0,0,0,0,0,0
8/08/2013,CCOM,CCOM Chirurgie,0,0,19,19,0,0,0
8/08/2013,CH Altkirch,Upatou,0,7,21,28,3,1,1
8/08/2013,CH de Colmar (CMC Le Parc),SAU Le Parc,3,0,29,32,5,0,0
8/08/2013,CH de Colmar (Louis Pasteur),SAU Pasteur,0,26,94,120,18,11,0
8/08/2013,CH de Guebwiller,UHTCD,1,4,36,41,0,3,0
8/08/2013,CH de Mulhouse ( Hasenrain),PEDIATRIE NEONATOLOGIE,8,0,18,26,5,0,0
8/08/2013,CH de Mulhouse (Emile Muller-Moenschberg,URGENCES,0,26,119,145,13,10,11
8/08/2013,CH de Saverne,PEDIATRIE,3,0,14,17,1,1,1
8/08/2013,CH de Saverne,S.A.U. (ADULTES),0,11,41,52,7,4,1
8/08/2013,CH de Sélestat,Acceuil des urgences,0,14,72,86,16,4,3
8/08/2013,CH de Thann,Urgences,1,5,39,45,5,3,1
8/08/2013,CHU de Strasbourg (Hôp. Civil),Urgences Médico-Chirurgicales NHC,1,14,70,85,41,9,1
8/08/2013,CHU de Strasbourg(Hautepierre),Urgences chirurgicales pédiatriques,11,0,24,35,8,8,0
8/08/2013,CHU de Strasbourg(Hautepierre),Gynéco-Obstétrique (HTP),0,0,16,16,11,0,0
8/08/2013,CHU de Strasbourg(Hautepierre),Urgences Adulte HTP,0,24,78,102,39,0,0
8/08/2013,CHU de Strasbourg(Hautepierre),Urgences chirurgicales pédiatriques,0,0,31,31,5,5,0
8/08/2013,Clinique des 3 Frontières,UPATOU (Structure des urgences),0,6,34,40,9,0,1
8/08/2013,Clinique Ste Odile (Strasbourg,UPATOU,1,5,51,57,1,6,2
8/08/2013,CMCO,GYNECO-OBSTETRIQUE,0,0,0,0,0,0,0
8/08/2013,SIHCUS/CMCO,GYNECOLOGIE ET OBSTETRIQUE - CMCO,0,0,0,0,0,0,0
7/08/2013,CCOM,CCOM Chirurgie,0,3,19,22,6,0,0
7/08/2013,CH Altkirch,Upatou,1,10,40,51,1,1,4
7/08/2013,CH de Colmar (CMC Le Parc),SAU Le Parc,5,0,35,40,4,0,0
7/08/2013,CH de Colmar (Louis Pasteur),SAU Pasteur,0,19,116,135,21,15,0
7/08/2013,CH de Guebwiller,UHTCD,0,3,33,36,1,2,3
7/08/2013,CH de Mulhouse ( Hasenrain),PEDIATRIE NEONATOLOGIE,11,0,31,42,5,0,0
7/08/2013,CH de Mulhouse (Emile Muller-Moenschberg,URGENCES,1,26,91,118,8,15,3
7/08/2013,CH de Saverne,S.A.U. (ADULTES),0,7,33,40,8,7,1
7/08/2013,CH de Saverne,PEDIATRIE,4,0,14,18,1,0,0
7/08/2013,CH de Sélestat,Acceuil des urgences,0,14,54,68,16,3,4
7/08/2013,CH de Thann,Urgences,0,4,46,50,3,2,2
7/08/2013,CHU de Strasbourg (Hôp. Civil),Urgences Médico-Chirurgicales NHC,0,13,54,67,44,7,0
7/08/2013,CHU de Strasbourg(Hautepierre),Urgences chirurgicales pédiatriques,8,0,14,22,3,3,0
7/08/2013,CHU de Strasbourg(Hautepierre),Gynéco-Obstétrique (HTP),0,0,30,30,7,0,0
7/08/2013,CHU de Strasbourg(Hautepierre),Urgences Adulte HTP,1,10,55,66,20,0,0
7/08/2013,CHU de Strasbourg(Hautepierre),Urgences chirurgicales pédiatriques,4,0,28,32,2,2,0
7/08/2013,Clinique des 3 Frontières,UPATOU (Structure des urgences),2,5,28,35,3,1,0
7/08/2013,Clinique des Diaconesses,SOS Main,0,1,29,30,9,0,0
7/08/2013,Clinique Ste Odile (Strasbourg,UPATOU,0,3,56,59,0,4,0
7/08/2013,CMCO,GYNECO-OBSTETRIQUE,0,0,0,0,0,0,0
7/08/2013,SIHCUS/CMCO,GYNECOLOGIE ET OBSTETRIQUE - CMCO,0,0,0,0,0,0,0
6/08/2013,CCOM,CCOM Chirurgie,0,1,26,27,3,0,0
6/08/2013,CH Altkirch,Upatou,0,6,21,27,2,1,1
6/08/2013,CH de Colmar (CMC Le Parc),SAU Le Parc,8,0,38,46,5,0,0
6/08/2013,CH de Colmar (Louis Pasteur),SAU Pasteur,0,23,88,111,16,9,0
6/08/2013,CH de Guebwiller,UHTCD,0,5,43,48,0,1,2
6/08/2013,CH de Mulhouse ( Hasenrain),PEDIATRIE NEONATOLOGIE,12,0,15,27,3,0,1
6/08/2013,CH de Mulhouse (Emile Muller-Moenschberg,URGENCES,0,26,96,122,16,10,3
6/08/2013,CH de Saverne,PEDIATRIE,4,0,12,16,2,0,0
6/08/2013,CH de Saverne,S.A.U. (ADULTES),0,10,47,57,11,4,1
6/08/2013,CH de Sélestat,Acceuil des urgences,0,11,61,72,11,5,1
6/08/2013,CH de Thann,Urgences,0,8,26,34,4,0,0
6/08/2013,CHU de Strasbourg (Hôp. Civil),Urgences Médico-Chirurgicales NHC,0,21,67,88,46,4,3
6/08/2013,CHU de Strasbourg(Hautepierre),Urgences chirurgicales pédiatriques,13,0,31,44,7,7,0
6/08/2013,CHU de Strasbourg(Hautepierre),Gynéco-Obstétrique (HTP),1,1,28,30,14,0,0
6/08/2013,CHU de Strasbourg(Hautepierre),Urgences chirurgicales pédiatriques,2,0,23,25,1,1,0
6/08/2013,CHU de Strasbourg(Hautepierre),Urgences Adulte HTP,0,15,77,92,36,0,0
6/08/2013,Clinique des 3 Frontières,UPATOU (Structure des urgences),0,3,33,36,3,0,2
6/08/2013,Clinique des Diaconesses,SOS Main,0,0,25,25,9,0,0
6/08/2013,Clinique Ste Odile (Strasbourg,UPATOU,1,4,54,59,0,5,4
6/08/2013,CMCO,GYNECO-OBSTETRIQUE,0,0,0,0,0,0,0
6/08/2013,SIHCUS/CMCO,GYNECOLOGIE ET OBSTETRIQUE - CMCO,0,0,0,0,0,0,0
5/08/2013,CCOM,CCOM Chirurgie,0,2,35,37,4,0,0
5/08/2013,CH Altkirch,Upatou,0,7,34,41,5,1,1
5/08/2013,CH de Colmar (CMC Le Parc),SAU Le Parc,6,0,29,35,5,0,1
5/08/2013,CH de Colmar (Louis Pasteur),SAU Pasteur,0,28,136,164,19,10,0
5/08/2013,CH de Guebwiller,UHTCD,0,11,43,54,3,1,2
5/08/2013,CH de Mulhouse ( Hasenrain),PEDIATRIE NEONATOLOGIE,7,0,16,23,2,0,0
5/08/2013,CH de Mulhouse (Emile Muller-Moenschberg,URGENCES,1,24,126,151,15,13,3
5/08/2013,CH de Saverne,S.A.U. (ADULTES),0,15,47,62,9,4,1
5/08/2013,CH de Saverne,PEDIATRIE,4,0,13,17,2,0,0
5/08/2013,CH de Sélestat,Acceuil des urgences,3,14,79,96,17,5,1
5/08/2013,CH de Thann,Urgences,0,9,30,39,4,2,0
5/08/2013,CHU de Strasbourg (Hôp. Civil),Urgences Médico-Chirurgicales NHC,0,17,66,83,43,4,4
5/08/2013,CHU de Strasbourg(Hautepierre),Urgences Adulte HTP,1,20,93,114,42,0,0
5/08/2013,CHU de Strasbourg(Hautepierre),Urgences chirurgicales pédiatriques,0,0,39,39,4,4,0
5/08/2013,CHU de Strasbourg(Hautepierre),Urgences chirurgicales pédiatriques,9,0,23,32,4,3,0
5/08/2013,CHU de Strasbourg(Hautepierre),Gynéco-Obstétrique (HTP),1,0,33,34,13,0,0
5/08/2013,Clinique des 3 Frontières,UPATOU (Structure des urgences),2,7,35,44,9,0,0
5/08/2013,Clinique Ste Odile (Strasbourg,UPATOU,0,8,64,72,1,4,1
5/08/2013,CMCO,GYNECO-OBSTETRIQUE,0,0,0,0,0,0,0
5/08/2013,SIHCUS/CMCO,GYNECOLOGIE ET OBSTETRIQUE - CMCO,0,0,0,0,0,0,0
4/08/2013,CCOM,CCOM Chirurgie,0,1,13,14,3,0,0
4/08/2013,CH Altkirch,Upatou,0,4,34,38,5,2,0
4/08/2013,CH de Colmar (CMC Le Parc),SAU Le Parc,8,0,42,50,2,0,0
4/08/2013,CH de Colmar (Louis Pasteur),SAU Pasteur,0,19,126,145,17,9,0
4/08/2013,CH de Guebwiller,UHTCD,1,5,51,57,1,5,0
4/08/2013,CH de Mulhouse ( Hasenrain),PEDIATRIE NEONATOLOGIE,14,0,18,32,2,0,0
4/08/2013,CH de Mulhouse (Emile Muller-Moenschberg,URGENCES,1,19,118,138,12,11,4
4/08/2013,CH de Saverne,S.A.U. (ADULTES),0,8,44,52,9,0,0
4/08/2013,CH de Saverne,PEDIATRIE,1,0,21,22,2,1,0
4/08/2013,CH de Sélestat,Acceuil des urgences,0,10,74,84,18,5,1
4/08/2013,CH de Thann,Urgences,1,7,47,55,1,0,2
4/08/2013,CH de Wissembourg,Urgences ,1,3,42,46,2,0,1
4/08/2013,CHU de Strasbourg (Hôp. Civil),Urgences Médico-Chirurgicales NHC,0,21,76,97,29,1,1
4/08/2013,CHU de Strasbourg(Hautepierre),Urgences chirurgicales pédiatriques,12,0,27,39,5,5,1
4/08/2013,CHU de Strasbourg(Hautepierre),Gynéco-Obstétrique (HTP),1,0,22,23,8,0,0
4/08/2013,CHU de Strasbourg(Hautepierre),Urgences chirurgicales pédiatriques,0,0,36,36,3,3,0
4/08/2013,CHU de Strasbourg(Hautepierre),Urgences Adulte HTP,1,17,84,102,30,0,2
4/08/2013,Clinique des 3 Frontières,UPATOU (Structure des urgences),0,2,45,47,1,0,0
4/08/2013,Clinique Ste Odile (Strasbourg,UPATOU,0,3,79,82,2,6,2
4/08/2013,CMCO,GYNECO-OBSTETRIQUE,0,0,0,0,0,0,0
4/08/2013,SIHCUS/CMCO,GYNECOLOGIE ET OBSTETRIQUE - CMCO,0,0,0,0,0,0,0
3/08/2013,CCOM,CCOM Chirurgie,0,0,22,22,3,0,0
3/08/2013,CH Altkirch,Upatou,0,5,37,42,5,0,2
3/08/2013,CH de Colmar (CMC Le Parc),SAU Le Parc,4,0,31,35,5,0,0
3/08/2013,CH de Colmar (Louis Pasteur),SAU Pasteur,0,19,104,123,21,11,2
3/08/2013,CH de Guebwiller,UHTCD,0,4,36,40,0,1,0
3/08/2013,CH de Mulhouse ( Hasenrain),PEDIATRIE NEONATOLOGIE,7,0,31,38,3,1,1
3/08/2013,CH de Mulhouse (Emile Muller-Moenschberg,URGENCES,1,18,114,133,11,10,4
3/08/2013,CH de Saverne,S.A.U. (ADULTES),0,8,40,48,9,3,1
3/08/2013,CH de Saverne,PEDIATRIE,4,0,16,20,0,1,0
3/08/2013,CH de Sélestat,Acceuil des urgences,5,17,81,103,12,5,0
3/08/2013,CH de Thann,Urgences,2,5,36,43,0,4,1
3/08/2013,CH de Wissembourg,Urgences ,0,7,41,48,6,1,1
3/08/2013,CHU de Strasbourg (Hôp. Civil),Urgences Médico-Chirurgicales NHC,0,15,95,110,40,0,1
3/08/2013,CHU de Strasbourg(Hautepierre),Urgences Adulte HTP,0,9,66,75,23,0,1
3/08/2013,CHU de Strasbourg(Hautepierre),Urgences chirurgicales pédiatriques,4,0,37,41,6,6,0
3/08/2013,CHU de Strasbourg(Hautepierre),Urgences chirurgicales pédiatriques,11,0,32,43,6,6,0
3/08/2013,CHU de Strasbourg(Hautepierre),Gynéco-Obstétrique (HTP),0,0,22,22,8,0,0
3/08/2013,Clinique des 3 Frontières,UPATOU (Structure des urgences),1,8,57,66,7,0,1
3/08/2013,Clinique Ste Odile (Strasbourg,UPATOU,0,0,77,77,2,6,2
3/08/2013,CMCO,GYNECO-OBSTETRIQUE,0,0,0,0,0,0,0
3/08/2013,SIHCUS/CMCO,GYNECOLOGIE ET OBSTETRIQUE - CMCO,0,0,0,0,0,0,0
2/08/2013,CCOM,CCOM Chirurgie,0,2,22,24,1,0,0
2/08/2013,CH Altkirch,Upatou,0,5,41,46,9,2,1
2/08/2013,CH de Colmar (CMC Le Parc),SAU Le Parc,11,0,24,35,2,0,0
2/08/2013,CH de Colmar (Louis Pasteur),SAU Pasteur,2,21,91,114,25,12,6
2/08/2013,CH de Guebwiller,UHTCD,1,6,31,38,1,1,0
2/08/2013,CH de Mulhouse ( Hasenrain),PEDIATRIE NEONATOLOGIE,7,0,22,29,5,1,0
2/08/2013,CH de Mulhouse (Emile Muller-Moenschberg,URGENCES,2,19,104,125,14,7,7
2/08/2013,CH de Saverne,S.A.U. (ADULTES),0,13,55,68,15,4,1
2/08/2013,CH de Saverne,PEDIATRIE,4,0,18,22,1,0,0
2/08/2013,CH de Sélestat,Acceuil des urgences,1,12,75,88,16,7,2
2/08/2013,CH de Thann,Urgences,1,3,31,35,0,2,2
2/08/2013,CH de Wissembourg,Urgences ,0,3,26,29,3,0,0
2/08/2013,CHU de Strasbourg (Hôp. Civil),Urgences Médico-Chirurgicales NHC,0,14,66,80,32,3,2
2/08/2013,CHU de Strasbourg(Hautepierre),Gynéco-Obstétrique (HTP),0,1,24,25,8,0,0
2/08/2013,CHU de Strasbourg(Hautepierre),Urgences Adulte HTP,0,18,91,109,48,0,1
2/08/2013,CHU de Strasbourg(Hautepierre),Urgences chirurgicales pédiatriques,1,0,33,34,6,6,0
2/08/2013,CHU de Strasbourg(Hautepierre),Urgences chirurgicales pédiatriques,7,0,21,28,4,3,0
2/08/2013,Clinique des 3 Frontières,UPATOU (Structure des urgences),1,5,23,29,2,0,0
2/08/2013,Clinique Ste Odile (Strasbourg,UPATOU,0,4,55,59,1,4,2
2/08/2013,CMCO,GYNECO-OBSTETRIQUE,0,0,0,0,0,0,0
2/08/2013,SIHCUS/CMCO,GYNECOLOGIE ET OBSTETRIQUE - CMCO,0,0,0,0,0,0,0
1/08/2013,CCOM,CCOM Chirurgie,1,1,21,23,3,0,0
1/08/2013,CH Altkirch,Upatou,0,11,42,53,7,2,2
1/08/2013,CH de Colmar (CMC Le Parc),SAU Le Parc,6,0,33,39,7,0,1
1/08/2013,CH de Colmar (Louis Pasteur),SAU Pasteur,0,21,109,130,17,8,0
1/08/2013,CH de Mulhouse ( Hasenrain),PEDIATRIE NEONATOLOGIE,5,0,32,37,2,0,1
1/08/2013,CH de Mulhouse (Emile Muller-Moenschberg,URGENCES,0,12,104,116,11,8,4
1/08/2013,CH de Saverne,S.A.U. (ADULTES),0,3,40,43,5,3,1
1/08/2013,CH de Saverne,PEDIATRIE,6,0,19,25,2,0,0
1/08/2013,CH de Sélestat,Acceuil des urgences,0,14,84,98,18,7,0
1/08/2013,CH de Thann,Urgences,1,5,34,40,3,0,3
1/08/2013,CH de Wissembourg,Urgences ,0,4,24,28,4,0,1
1/08/2013,CHU de Strasbourg (Hôp. Civil),Urgences Médico-Chirurgicales NHC,0,18,69,87,39,4,1
1/08/2013,CHU de Strasbourg(Hautepierre),Urgences Adulte HTP,0,20,69,89,43,0,1
1/08/2013,CHU de Strasbourg(Hautepierre),Urgences chirurgicales pédiatriques,1,0,34,35,5,5,0
1/08/2013,CHU de Strasbourg(Hautepierre),Urgences chirurgicales pédiatriques,8,0,25,33,3,3,0
1/08/2013,CHU de Strasbourg(Hautepierre),Gynéco-Obstétrique (HTP),1,0,25,26,12,0,0
1/08/2013,Clinique des 3 Frontières,UPATOU (Structure des urgences),0,4,43,47,9,0,0
1/08/2013,Clinique Ste Odile (Strasbourg,UPATOU,0,1,54,55,2,8,1
1/08/2013,CMCO,GYNECO-OBSTETRIQUE,0,0,0,0,0,0,0
1/08/2013,SIHCUS/CMCO,GYNECOLOGIE ET OBSTETRIQUE - CMCO,0,0,0,0,0,0,0
30/09/2013,CCOM,CCOM Chirurgie,0,3,37,40,3,0,0
30/09/2013,CH Altkirch,Upatou,0,4,41,45,0,2,2
30/09/2013,CH de Colmar (CMC Le Parc),SAU Le Parc,3,0,49,52,3,0,0
30/09/2013,CH de Colmar (Louis Pasteur),SAU Pasteur,0,26,107,133,24,12,3
30/09/2013,CH de Guebwiller,UHTCD,0,2,51,53,3,1,2
30/09/2013,CH de Mulhouse ( Hasenrain),PEDIATRIE NEONATOLOGIE,9,0,38,47,6,0,0
30/09/2013,CH de Mulhouse (Emile Muller-Moenschberg,URGENCES,1,22,126,149,19,11,2
30/09/2013,CH de Saverne,S.A.U. (ADULTES),0,8,72,80,17,6,1
30/09/2013,CH de Saverne,PEDIATRIE,5,0,23,28,3,1,0
30/09/2013,CH de Thann,Urgences,0,7,46,53,6,1,2
30/09/2013,CH de Wissembourg,Urgences ,1,5,32,38,9,0,1
30/09/2013,CHU de Strasbourg (Hôp. Civil),Urgences Médico-Chirurgicales NHC,0,22,60,82,49,4,1
30/09/2013,CHU de Strasbourg(Hautepierre),Urgences chirurgicales pédiatriques,7,0,41,48,7,7,0
30/09/2013,CHU de Strasbourg(Hautepierre),Gynéco-Obstétrique (HTP),1,0,16,17,9,0,0
30/09/2013,CHU de Strasbourg(Hautepierre),Urgences Adulte HTP,0,17,82,99,31,0,0
30/09/2013,CHU de Strasbourg(Hautepierre),Urgences chirurgicales pédiatriques,7,0,52,59,0,0,0
30/09/2013,Clinique des 3 Frontières,UPATOU (Structure des urgences),2,8,35,45,7,0,0
30/09/2013,Clinique des Diaconesses,SOS Main,0,0,35,35,8,0,0
30/09/2013,Clinique Ste Odile (Strasbourg,UPATOU,0,5,71,76,2,5,2
30/09/2013,CMCO,GYNECO-OBSTETRIQUE,0,0,0,0,0,0,0
30/09/2013,SIHCUS/CMCO,GYNECOLOGIE ET OBSTETRIQUE - CMCO,0,0,0,0,0,0,0
29/09/2013,CCOM,CCOM Chirurgie,0,3,16,19,3,0,0
29/09/2013,CH Altkirch,Upatou,0,4,33,37,9,1,1
29/09/2013,CH de Colmar (CMC Le Parc),SAU Le Parc,9,0,48,57,4,0,0
29/09/2013,CH de Colmar (Louis Pasteur),SAU Pasteur,0,13,100,113,23,4,0
29/09/2013,CH de Guebwiller,UHTCD,1,6,49,56,2,1,0
29/09/2013,CH de Mulhouse ( Hasenrain),PEDIATRIE NEONATOLOGIE,8,0,30,38,6,0,0
29/09/2013,CH de Mulhouse (Emile Muller-Moenschberg,URGENCES,0,19,117,136,10,10,1
29/09/2013,CH de Saverne,S.A.U. (ADULTES),0,8,48,56,11,2,0
29/09/2013,CH de Saverne,PEDIATRIE,6,0,35,41,1,0,0
29/09/2013,CH de Thann,Urgences,0,5,48,53,2,3,8
29/09/2013,CH de Wissembourg,Urgences ,1,5,40,46,4,0,1
29/09/2013,CHU de Strasbourg (Hôp. Civil),Urgences Médico-Chirurgicales NHC,0,19,68,87,31,5,0
29/09/2013,CHU de Strasbourg(Hautepierre),Urgences chirurgicales pédiatriques,2,0,66,68,4,4,0
29/09/2013,CHU de Strasbourg(Hautepierre),Urgences chirurgicales pédiatriques,17,0,64,81,8,8,0
29/09/2013,CHU de Strasbourg(Hautepierre),Urgences Adulte HTP,0,9,91,100,29,0,0
29/09/2013,CHU de Strasbourg(Hautepierre),Gynéco-Obstétrique (HTP),0,0,21,21,5,0,0
29/09/2013,Clinique des 3 Frontières,UPATOU (Structure des urgences),0,1,45,46,2,0,1
29/09/2013,Clinique Ste Odile (Strasbourg,UPATOU,2,3,92,97,0,7,0
29/09/2013,CMCO,GYNECO-OBSTETRIQUE,0,0,0,0,0,0,0
29/09/2013,SIHCUS/CMCO,GYNECOLOGIE ET OBSTETRIQUE - CMCO,0,0,0,0,0,0,0
28/09/2013,CCOM,CCOM Chirurgie,0,0,19,19,2,0,0
28/09/2013,CH Altkirch,Upatou,0,5,42,47,5,2,3
28/09/2013,CH de Colmar (CMC Le Parc),SAU Le Parc,4,0,45,49,3,0,0
28/09/2013,CH de Colmar (Louis Pasteur),SAU Pasteur,1,11,102,114,32,13,0
28/09/2013,CH de Guebwiller,UHTCD,0,3,36,39,1,0,3
28/09/2013,CH de Mulhouse ( Hasenrain),PEDIATRIE NEONATOLOGIE,13,0,29,42,3,1,1
28/09/2013,CH de Mulhouse (Emile Muller-Moenschberg,URGENCES,1,21,168,190,16,11,2
28/09/2013,CH de Saverne,S.A.U. (ADULTES),0,8,48,56,8,2,2
28/09/2013,CH de Saverne,PEDIATRIE,7,0,22,29,2,1,0
28/09/2013,CH de Thann,Urgences,0,5,39,44,4,1,1
28/09/2013,CH de Wissembourg,Urgences ,1,5,36,42,4,0,0
28/09/2013,CHU de Strasbourg (Hôp. Civil),Urgences Médico-Chirurgicales NHC,0,15,94,109,37,8,0
28/09/2013,CHU de Strasbourg(Hautepierre),Urgences Adulte HTP,0,17,88,105,31,0,1
28/09/2013,CHU de Strasbourg(Hautepierre),Urgences chirurgicales pédiatriques,10,0,41,51,9,8,0
28/09/2013,CHU de Strasbourg(Hautepierre),Gynéco-Obstétrique (HTP),0,0,31,31,10,0,0
28/09/2013,CHU de Strasbourg(Hautepierre),Urgences chirurgicales pédiatriques,0,0,59,59,5,4,0
28/09/2013,Clinique des 3 Frontières,UPATOU (Structure des urgences),1,5,52,58,6,0,1
28/09/2013,Clinique Ste Odile (Strasbourg,UPATOU,0,8,79,87,0,5,0
28/09/2013,CMCO,GYNECO-OBSTETRIQUE,0,0,0,0,0,0,0
28/09/2013,SIHCUS/CMCO,GYNECOLOGIE ET OBSTETRIQUE - CMCO,0,0,0,0,0,0,0
27/09/2013,CCOM,CCOM Chirurgie,0,2,23,25,1,0,0
27/09/2013,CH Altkirch,Upatou,0,13,23,36,10,1,0
27/09/2013,CH de Colmar (CMC Le Parc),SAU Le Parc,5,0,41,46,5,0,0
27/09/2013,CH de Colmar (Louis Pasteur),SAU Pasteur,0,25,85,110,27,8,1
27/09/2013,CH de Guebwiller,UHTCD,0,6,40,46,1,0,2
27/09/2013,CH de Mulhouse ( Hasenrain),PEDIATRIE NEONATOLOGIE,13,0,29,42,5,2,0
27/09/2013,CH de Mulhouse (Emile Muller-Moenschberg,URGENCES,1,18,127,146,11,11,3
27/09/2013,CH de Saverne,S.A.U. (ADULTES),0,12,45,57,10,6,0
27/09/2013,CH de Saverne,PEDIATRIE,4,0,15,19,0,1,0
27/09/2013,CH de Thann,Urgences,1,6,31,38,3,1,0
27/09/2013,CHU de Strasbourg (Hôp. Civil),Urgences Médico-Chirurgicales NHC,0,25,64,89,47,11,3
27/09/2013,CHU de Strasbourg(Hautepierre),Urgences chirurgicales pédiatriques,12,0,42,54,11,13,0
27/09/2013,CHU de Strasbourg(Hautepierre),Gynéco-Obstétrique (HTP),3,1,27,31,12,0,0
27/09/2013,CHU de Strasbourg(Hautepierre),Urgences Adulte HTP,0,18,82,100,39,0,0
27/09/2013,CHU de Strasbourg(Hautepierre),Urgences chirurgicales pédiatriques,1,0,59,60,3,3,0
27/09/2013,Clinique des 3 Frontières,UPATOU (Structure des urgences),1,2,39,42,3,0,0
27/09/2013,Clinique des Diaconesses,SOS Main,0,2,32,34,0,0,1
27/09/2013,Clinique Ste Odile (Strasbourg,UPATOU,0,2,69,71,0,9,3
27/09/2013,CMCO,GYNECO-OBSTETRIQUE,0,0,0,0,0,0,0
27/09/2013,SIHCUS/CMCO,GYNECOLOGIE ET OBSTETRIQUE - CMCO,0,0,0,0,0,0,0
26/09/2013,CCOM,CCOM Chirurgie,0,2,19,21,2,0,0
26/09/2013,CH Altkirch,Upatou,0,4,37,41,1,1,0
26/09/2013,CH de Colmar (CMC Le Parc),SAU Le Parc,7,0,42,49,4,0,0
26/09/2013,CH de Colmar (Louis Pasteur),SAU Pasteur,0,29,104,133,17,14,0
26/09/2013,CH de Guebwiller,UHTCD,0,4,33,37,4,3,1
26/09/2013,CH de Mulhouse ( Hasenrain),PEDIATRIE NEONATOLOGIE,11,0,28,39,8,2,1
26/09/2013,CH de Mulhouse (Emile Muller-Moenschberg,URGENCES,0,19,127,146,7,13,3
26/09/2013,CH de Saverne,S.A.U. (ADULTES),0,9,38,47,12,5,1
26/09/2013,CH de Saverne,PEDIATRIE,3,0,14,17,2,1,0
26/09/2013,CH de Thann,Urgences,0,10,45,55,4,0,2
26/09/2013,CHU de Strasbourg (Hôp. Civil),Urgences Médico-Chirurgicales NHC,0,19,53,72,33,8,2
26/09/2013,CHU de Strasbourg(Hautepierre),Urgences chirurgicales pédiatriques,14,0,36,50,6,5,0
26/09/2013,CHU de Strasbourg(Hautepierre),Gynéco-Obstétrique (HTP),0,0,27,27,11,0,0
26/09/2013,CHU de Strasbourg(Hautepierre),Urgences Adulte HTP,0,13,61,74,24,0,0
26/09/2013,CHU de Strasbourg(Hautepierre),Urgences chirurgicales pédiatriques,1,0,46,47,5,5,0
26/09/2013,Clinique des 3 Frontières,UPATOU (Structure des urgences),1,8,48,57,5,0,2
26/09/2013,Clinique des Diaconesses,SOS Main,0,1,45,46,1,0,0
26/09/2013,Clinique Ste Odile (Strasbourg,UPATOU,0,4,86,90,2,7,2
26/09/2013,CMCO,GYNECO-OBSTETRIQUE,0,0,0,0,0,0,0
26/09/2013,SIHCUS/CMCO,GYNECOLOGIE ET OBSTETRIQUE - CMCO,0,0,0,0,0,0,0
25/09/2013,CCOM,CCOM Chirurgie,0,0,21,21,1,0,0
25/09/2013,CH Altkirch,Upatou,1,4,37,42,3,0,0
25/09/2013,CH de Colmar (CMC Le Parc),SAU Le Parc,12,0,43,55,6,0,0
25/09/2013,CH de Colmar (Louis Pasteur),SAU Pasteur,0,21,105,126,19,11,0
25/09/2013,CH de Guebwiller,UHTCD,0,7,30,37,2,1,2
25/09/2013,CH de Mulhouse ( Hasenrain),PEDIATRIE NEONATOLOGIE,9,0,26,35,2,2,0
25/09/2013,CH de Mulhouse (Emile Muller-Moenschberg,URGENCES,0,25,102,127,17,8,2
25/09/2013,CH de Saverne,S.A.U. (ADULTES),0,10,31,41,8,1,1
25/09/2013,CH de Saverne,PEDIATRIE,2,0,12,14,1,2,0
25/09/2013,CH de Thann,Urgences,0,4,31,35,4,1,0
25/09/2013,CH de Wissembourg,Urgences ,0,4,25,29,9,0,0
25/09/2013,CHU de Strasbourg (Hôp. Civil),Urgences Médico-Chirurgicales NHC,0,13,66,79,30,6,0
25/09/2013,CHU de Strasbourg(Hautepierre),Urgences chirurgicales pédiatriques,8,0,44,52,6,6,0
25/09/2013,CHU de Strasbourg(Hautepierre),Gynéco-Obstétrique (HTP),1,0,27,28,11,0,0
25/09/2013,CHU de Strasbourg(Hautepierre),Urgences chirurgicales pédiatriques,4,0,53,57,3,3,0
25/09/2013,CHU de Strasbourg(Hautepierre),Urgences Adulte HTP,0,19,69,88,33,0,1
25/09/2013,Clinique des 3 Frontières,UPATOU (Structure des urgences),0,5,33,38,5,0,0
25/09/2013,Clinique Ste Odile (Strasbourg,UPATOU,0,3,69,72,0,4,0
25/09/2013,CMCO,GYNECO-OBSTETRIQUE,0,0,0,0,0,0,0
25/09/2013,SIHCUS/CMCO,GYNECOLOGIE ET OBSTETRIQUE - CMCO,0,0,0,0,0,0,0
24/09/2013,CCOM,CCOM Chirurgie,0,2,22,24,1,0,0
24/09/2013,CH Altkirch,Upatou,0,4,32,36,6,2,2
24/09/2013,CH de Colmar (CMC Le Parc),SAU Le Parc,10,0,43,53,5,0,0
24/09/2013,CH de Colmar (Louis Pasteur),SAU Pasteur,0,19,115,134,20,12,1
24/09/2013,CH de Guebwiller,UHTCD,0,6,32,38,4,2,0
24/09/2013,CH de Mulhouse ( Hasenrain),PEDIATRIE NEONATOLOGIE,9,0,25,34,5,1,0
24/09/2013,CH de Mulhouse (Emile Muller-Moenschberg,URGENCES,1,19,110,130,9,11,2
24/09/2013,CH de Saverne,PEDIATRIE,3,0,15,18,3,1,0
24/09/2013,CH de Saverne,S.A.U. (ADULTES),0,7,35,42,7,3,0
24/09/2013,CH de Thann,Urgences,0,8,33,41,3,3,0
24/09/2013,CH de Wissembourg,Urgences ,1,10,29,40,10,0,1
24/09/2013,CHU de Strasbourg (Hôp. Civil),Urgences Médico-Chirurgicales NHC,0,24,57,81,46,4,2
24/09/2013,CHU de Strasbourg(Hautepierre),Gynéco-Obstétrique (HTP),0,0,19,19,12,0,0
24/09/2013,CHU de Strasbourg(Hautepierre),Urgences chirurgicales pédiatriques,2,0,48,50,2,2,0
24/09/2013,CHU de Strasbourg(Hautepierre),Urgences Adulte HTP,0,20,76,96,39,0,0
24/09/2013,CHU de Strasbourg(Hautepierre),Urgences chirurgicales pédiatriques,12,0,36,48,9,9,0
24/09/2013,Clinique des 3 Frontières,UPATOU (Structure des urgences),0,3,30,33,6,0,0
24/09/2013,Clinique Ste Odile (Strasbourg,UPATOU,1,3,52,56,1,5,2
24/09/2013,CMCO,GYNECO-OBSTETRIQUE,0,0,0,0,0,0,0
24/09/2013,SIHCUS/CMCO,GYNECOLOGIE ET OBSTETRIQUE - CMCO,0,0,0,0,0,0,0
23/09/2013,CCOM,CCOM Chirurgie,0,2,39,41,1,0,0
23/09/2013,CH Altkirch,Upatou,0,7,44,51,5,1,0
23/09/2013,CH de Colmar (CMC Le Parc),SAU Le Parc,7,0,38,45,8,0,0
23/09/2013,CH de Colmar (Louis Pasteur),SAU Pasteur,0,14,129,143,24,12,0
23/09/2013,CH de Guebwiller,UHTCD,0,4,37,41,1,1,1
23/09/2013,CH de Mulhouse ( Hasenrain),PEDIATRIE NEONATOLOGIE,10,0,30,40,7,1,1
23/09/2013,CH de Mulhouse (Emile Muller-Moenschberg,URGENCES,2,27,103,132,14,11,5
23/09/2013,CH de Saverne,S.A.U. (ADULTES),0,11,47,58,12,2,1
23/09/2013,CH de Saverne,PEDIATRIE,1,0,19,20,1,2,0
23/09/2013,CH de Thann,Urgences,0,2,42,44,1,2,1
23/09/2013,CH de Wissembourg,Urgences ,0,6,25,31,6,1,1
23/09/2013,CHU de Strasbourg (Hôp. Civil),Urgences Médico-Chirurgicales NHC,0,19,86,105,51,8,2
23/09/2013,CHU de Strasbourg(Hautepierre),Urgences chirurgicales pédiatriques,14,0,46,60,3,3,0
23/09/2013,CHU de Strasbourg(Hautepierre),Gynéco-Obstétrique (HTP),0,0,29,29,15,0,0
23/09/2013,CHU de Strasbourg(Hautepierre),Urgences Adulte HTP,0,13,85,98,29,0,0
23/09/2013,CHU de Strasbourg(Hautepierre),Urgences chirurgicales pédiatriques,5,0,60,65,7,7,0
23/09/2013,Clinique des 3 Frontières,UPATOU (Structure des urgences),0,5,45,50,5,0,0
23/09/2013,Clinique Ste Odile (Strasbourg,UPATOU,0,4,89,93,3,12,4
23/09/2013,CMCO,GYNECO-OBSTETRIQUE,0,0,0,0,0,0,0
23/09/2013,SIHCUS/CMCO,GYNECOLOGIE ET OBSTETRIQUE - CMCO,0,0,0,0,0,0,0
22/09/2013,CCOM,CCOM Chirurgie,0,1,17,18,1,0,0
22/09/2013,CH Altkirch,Upatou,0,4,33,37,1,1,1
22/09/2013,CH de Colmar (CMC Le Parc),SAU Le Parc,8,0,55,63,10,0,0
22/09/2013,CH de Colmar (Louis Pasteur),SAU Pasteur,0,15,116,131,30,12,1
22/09/2013,CH de Guebwiller,UHTCD,0,3,48,51,2,2,0
22/09/2013,CH de Mulhouse ( Hasenrain),PEDIATRIE NEONATOLOGIE,8,0,38,46,6,1,0
22/09/2013,CH de Mulhouse (Emile Muller-Moenschberg,URGENCES,3,24,112,139,11,11,4
22/09/2013,CH de Saverne,PEDIATRIE,6,0,28,34,3,0,0
22/09/2013,CH de Saverne,S.A.U. (ADULTES),0,16,44,60,13,5,0
22/09/2013,CH de Thann,Urgences,1,7,48,56,1,1,2
22/09/2013,CH de Wissembourg,Urgences ,2,2,37,41,6,0,1
22/09/2013,CHU de Strasbourg (Hôp. Civil),Urgences Médico-Chirurgicales NHC,0,17,64,81,32,2,1
22/09/2013,CHU de Strasbourg(Hautepierre),Urgences chirurgicales pédiatriques,13,0,54,67,12,11,0
22/09/2013,CHU de Strasbourg(Hautepierre),Gynéco-Obstétrique (HTP),0,0,21,21,11,0,0
22/09/2013,CHU de Strasbourg(Hautepierre),Urgences Adulte HTP,0,11,67,78,24,0,0
22/09/2013,CHU de Strasbourg(Hautepierre),Urgences chirurgicales pédiatriques,2,0,51,53,6,6,0
22/09/2013,Clinique des 3 Frontières,UPATOU (Structure des urgences),0,4,49,53,8,0,0
22/09/2013,Clinique Ste Odile (Strasbourg,UPATOU,0,4,92,96,2,4,1
22/09/2013,CMCO,GYNECO-OBSTETRIQUE,0,0,0,0,0,0,0
22/09/2013,SIHCUS/CMCO,GYNECOLOGIE ET OBSTETRIQUE - CMCO,0,0,0,0,0,0,0
21/09/2013,CCOM,CCOM Chirurgie,0,0,24,24,6,0,0
21/09/2013,CH Altkirch,Upatou,1,3,39,43,6,1,4
21/09/2013,CH de Colmar (CMC Le Parc),SAU Le Parc,10,0,47,57,4,0,0
21/09/2013,CH de Colmar (Louis Pasteur),SAU Pasteur,0,20,102,122,23,8,4
21/09/2013,CH de Guebwiller,UHTCD,0,2,38,40,1,3,3
21/09/2013,CH de Mulhouse ( Hasenrain),PEDIATRIE NEONATOLOGIE,12,0,25,37,4,1,0
21/09/2013,CH de Mulhouse (Emile Muller-Moenschberg,URGENCES,1,20,131,152,18,13,4
21/09/2013,CH de Saverne,PEDIATRIE,5,0,16,21,5,0,0
21/09/2013,CH de Saverne,S.A.U. (ADULTES),0,15,44,59,10,5,0
21/09/2013,CH de Thann,Urgences,0,5,50,55,2,1,1
21/09/2013,CH de Wissembourg,Urgences ,3,10,27,40,4,2,0
21/09/2013,CHU de Strasbourg (Hôp. Civil),Urgences Médico-Chirurgicales NHC,0,17,95,112,38,7,0
21/09/2013,CHU de Strasbourg(Hautepierre),Urgences chirurgicales pédiatriques,9,0,42,51,9,8,0
21/09/2013,CHU de Strasbourg(Hautepierre),Gynéco-Obstétrique (HTP),0,0,23,23,12,0,0
21/09/2013,CHU de Strasbourg(Hautepierre),Urgences chirurgicales pédiatriques,0,0,60,60,10,10,0
21/09/2013,CHU de Strasbourg(Hautepierre),Urgences Adulte HTP,0,15,77,92,27,0,0
21/09/2013,Clinique des 3 Frontières,UPATOU (Structure des urgences),0,1,53,54,4,0,1
21/09/2013,Clinique des Diaconesses,SOS Main,0,1,29,30,0,0,0
21/09/2013,Clinique Ste Odile (Strasbourg,UPATOU,2,11,75,88,3,5,2
21/09/2013,CMCO,GYNECO-OBSTETRIQUE,0,0,0,0,0,0,0
21/09/2013,SIHCUS/CMCO,GYNECOLOGIE ET OBSTETRIQUE - CMCO,0,0,0,0,0,0,0
20/09/2013,CCOM,CCOM Chirurgie,0,1,30,31,1,0,0
20/09/2013,CH Altkirch,Upatou,0,8,34,42,8,1,0
20/09/2013,CH de Colmar (CMC Le Parc),SAU Le Parc,5,0,37,42,7,0,0
20/09/2013,CH de Colmar (Louis Pasteur),SAU Pasteur,0,19,101,120,24,15,2
20/09/2013,CH de Guebwiller,UHTCD,0,1,29,30,1,1,1
20/09/2013,CH de Mulhouse ( Hasenrain),PEDIATRIE NEONATOLOGIE,10,0,18,28,7,2,0
20/09/2013,CH de Mulhouse (Emile Muller-Moenschberg,URGENCES,2,21,109,132,14,12,3
20/09/2013,CH de Saverne,S.A.U. (ADULTES),0,14,37,51,15,3,0
20/09/2013,CH de Saverne,PEDIATRIE,5,0,15,20,1,1,0
20/09/2013,CH de Thann,Urgences,0,6,29,35,3,2,0
20/09/2013,CH de Wissembourg,Urgences ,2,7,25,34,7,1,0
20/09/2013,CHU de Strasbourg (Hôp. Civil),Urgences Médico-Chirurgicales NHC,0,12,62,74,32,1,3
20/09/2013,CHU de Strasbourg(Hautepierre),Urgences chirurgicales pédiatriques,1,0,59,60,9,8,0
20/09/2013,CHU de Strasbourg(Hautepierre),Urgences chirurgicales pédiatriques,10,0,36,46,4,4,0
20/09/2013,CHU de Strasbourg(Hautepierre),Gynéco-Obstétrique (HTP),0,0,28,28,15,0,0
20/09/2013,CHU de Strasbourg(Hautepierre),Urgences Adulte HTP,0,17,77,94,33,0,0
20/09/2013,Clinique des 3 Frontières,UPATOU (Structure des urgences),1,5,32,38,5,0,0
20/09/2013,Clinique Ste Odile (Strasbourg,UPATOU,0,7,57,64,4,4,0
20/09/2013,CMCO,GYNECO-OBSTETRIQUE,0,0,0,0,0,0,0
20/09/2013,SIHCUS/CMCO,GYNECOLOGIE ET OBSTETRIQUE - CMCO,0,0,0,0,0,0,0
19/09/2013,CCOM,CCOM Chirurgie,0,0,28,28,2,0,0
19/09/2013,CH Altkirch,Upatou,0,5,23,28,9,0,0
19/09/2013,CH de Colmar (CMC Le Parc),SAU Le Parc,5,0,32,37,3,0,0
19/09/2013,CH de Colmar (Louis Pasteur),SAU Pasteur,0,24,97,121,27,9,0
19/09/2013,CH de Guebwiller,UHTCD,0,4,34,38,4,1,2
19/09/2013,CH de Mulhouse ( Hasenrain),PEDIATRIE NEONATOLOGIE,13,0,15,28,7,1,0
19/09/2013,CH de Mulhouse (Emile Muller-Moenschberg,URGENCES,1,25,106,132,15,11,3
19/09/2013,CH de Saverne,PEDIATRIE,4,0,16,20,2,0,0
19/09/2013,CH de Saverne,S.A.U. (ADULTES),0,10,32,42,8,2,1
19/09/2013,CH de Thann,Urgences,0,8,38,46,7,1,1
19/09/2013,CH de Wissembourg,Urgences ,1,7,21,29,9,0,3
19/09/2013,CHU de Strasbourg (Hôp. Civil),Urgences Médico-Chirurgicales NHC,0,15,62,77,38,8,1
19/09/2013,CHU de Strasbourg(Hautepierre),Urgences chirurgicales pédiatriques,1,0,54,55,3,3,0
19/09/2013,CHU de Strasbourg(Hautepierre),Urgences chirurgicales pédiatriques,12,0,36,48,6,6,0
19/09/2013,CHU de Strasbourg(Hautepierre),Gynéco-Obstétrique (HTP),0,1,30,31,10,0,0
19/09/2013,CHU de Strasbourg(Hautepierre),Urgences Adulte HTP,0,15,66,81,39,0,0
19/09/2013,Clinique des 3 Frontières,UPATOU (Structure des urgences),1,4,35,40,6,0,3
19/09/2013,Clinique Ste Odile (Strasbourg,UPATOU,0,3,68,71,2,10,2
19/09/2013,CMCO,GYNECO-OBSTETRIQUE,0,0,0,0,0,0,0
19/09/2013,SIHCUS/CMCO,GYNECOLOGIE ET OBSTETRIQUE - CMCO,0,0,0,0,0,0,0
18/09/2013,CCOM,CCOM Chirurgie,0,0,27,27,4,0,0
18/09/2013,CH Altkirch,Upatou,0,4,27,31,4,2,2
18/09/2013,CH de Colmar (CMC Le Parc),SAU Le Parc,8,0,28,36,8,0,0
18/09/2013,CH de Colmar (Louis Pasteur),SAU Pasteur,0,18,94,112,20,11,0
18/09/2013,CH de Guebwiller,UHTCD,0,5,41,46,3,2,0
18/09/2013,CH de Mulhouse ( Hasenrain),PEDIATRIE NEONATOLOGIE,11,0,24,35,5,2,0
18/09/2013,CH de Mulhouse (Emile Muller-Moenschberg,URGENCES,1,21,111,133,12,10,2
18/09/2013,CH de Saverne,S.A.U. (ADULTES),0,10,41,51,7,3,0
18/09/2013,CH de Saverne,PEDIATRIE,3,0,13,16,1,1,0
18/09/2013,CH de Thann,Urgences,0,5,42,47,3,4,2
18/09/2013,CH de Wissembourg,Urgences ,0,5,25,30,9,0,0
18/09/2013,CHU de Strasbourg (Hôp. Civil),Urgences Médico-Chirurgicales NHC,0,13,65,78,40,12,1
18/09/2013,CHU de Strasbourg(Hautepierre),Urgences chirurgicales pédiatriques,15,0,35,50,6,6,0
18/09/2013,CHU de Strasbourg(Hautepierre),Gynéco-Obstétrique (HTP),1,0,20,21,11,0,0
18/09/2013,CHU de Strasbourg(Hautepierre),Urgences chirurgicales pédiatriques,4,0,48,52,5,5,0
18/09/2013,CHU de Strasbourg(Hautepierre),Urgences Adulte HTP,0,20,76,96,43,0,0
18/09/2013,Clinique des 3 Frontières,UPATOU (Structure des urgences),0,2,35,37,3,0,1
18/09/2013,Clinique Ste Odile (Strasbourg,UPATOU,0,4,54,58,3,8,0
18/09/2013,CMCO,GYNECO-OBSTETRIQUE,0,0,0,0,0,0,0
18/09/2013,SIHCUS/CMCO,GYNECOLOGIE ET OBSTETRIQUE - CMCO,0,0,0,0,0,0,0
17/09/2013,CCOM,CCOM Chirurgie,0,2,30,32,3,0,0
17/09/2013,CH Altkirch,Upatou,0,6,26,32,5,2,0
17/09/2013,CH de Colmar (CMC Le Parc),SAU Le Parc,10,0,38,48,7,0,0
17/09/2013,CH de Colmar (Louis Pasteur),SAU Pasteur,0,22,90,112,21,11,0
17/09/2013,CH de Guebwiller,UHTCD,0,4,37,41,3,4,0
17/09/2013,CH de Mulhouse ( Hasenrain),PEDIATRIE NEONATOLOGIE,7,0,18,25,1,2,0
17/09/2013,CH de Mulhouse (Emile Muller-Moenschberg,URGENCES,2,21,95,118,11,16,6
17/09/2013,CH de Saverne,S.A.U. (ADULTES),0,12,48,60,12,2,0
17/09/2013,CH de Saverne,PEDIATRIE,3,0,6,9,1,0,0
17/09/2013,CH de Thann,Urgences,0,3,26,29,4,0,0
17/09/2013,CH de Wissembourg,Urgences ,0,5,22,27,6,1,0
17/09/2013,CHU de Strasbourg (Hôp. Civil),Urgences Médico-Chirurgicales NHC,0,12,52,64,30,5,1
17/09/2013,CHU de Strasbourg(Hautepierre),Urgences chirurgicales pédiatriques,3,0,43,46,5,5,0
17/09/2013,CHU de Strasbourg(Hautepierre),Urgences chirurgicales pédiatriques,12,0,36,48,5,4,0
17/09/2013,CHU de Strasbourg(Hautepierre),Gynéco-Obstétrique (HTP),1,0,26,27,13,0,0
17/09/2013,CHU de Strasbourg(Hautepierre),Urgences Adulte HTP,0,16,64,80,38,0,1
17/09/2013,Clinique des 3 Frontières,UPATOU (Structure des urgences),0,6,31,37,6,0,0
17/09/2013,Clinique des Diaconesses,SOS Main,0,1,21,22,5,0,0
17/09/2013,Clinique Ste Odile (Strasbourg,UPATOU,0,4,62,66,0,2,0
17/09/2013,CMCO,GYNECO-OBSTETRIQUE,0,0,0,0,0,0,0
17/09/2013,SIHCUS/CMCO,GYNECOLOGIE ET OBSTETRIQUE - CMCO,0,0,0,0,0,0,0
16/09/2013,CCOM,CCOM Chirurgie,0,2,18,20,1,0,0
16/09/2013,CH Altkirch,Upatou,2,6,25,33,1,0,1
16/09/2013,CH de Colmar (CMC Le Parc),SAU Le Parc,7,0,36,43,3,0,0
16/09/2013,CH de Colmar (Louis Pasteur),SAU Pasteur,0,25,97,122,21,12,0
16/09/2013,CH de Guebwiller,UHTCD,0,3,50,53,3,4,0
16/09/2013,CH de Mulhouse ( Hasenrain),PEDIATRIE NEONATOLOGIE,15,0,27,42,8,0,0
16/09/2013,CH de Mulhouse (Emile Muller-Moenschberg,URGENCES,2,26,98,126,31,5,3
16/09/2013,CH de Saverne,S.A.U. (ADULTES),0,6,43,49,9,4,0
16/09/2013,CH de Saverne,PEDIATRIE,4,0,13,17,2,1,1
16/09/2013,CH de Thann,Urgences,1,8,39,48,6,1,1
16/09/2013,CH de Wissembourg,Urgences ,1,3,34,38,11,0,0
16/09/2013,CHU de Strasbourg (Hôp. Civil),Urgences Médico-Chirurgicales NHC,0,13,68,81,42,3,0
16/09/2013,CHU de Strasbourg(Hautepierre),Urgences chirurgicales pédiatriques,16,0,37,53,3,3,0
16/09/2013,CHU de Strasbourg(Hautepierre),Gynéco-Obstétrique (HTP),0,0,22,22,9,0,0
16/09/2013,CHU de Strasbourg(Hautepierre),Urgences Adulte HTP,0,20,72,92,44,0,3
16/09/2013,CHU de Strasbourg(Hautepierre),Urgences chirurgicales pédiatriques,0,0,53,53,1,1,0
16/09/2013,Clinique des 3 Frontières,UPATOU (Structure des urgences),0,2,39,41,3,0,1
16/09/2013,Clinique des Diaconesses,SOS Main,0,0,43,43,9,0,1
16/09/2013,Clinique Ste Odile (Strasbourg,UPATOU,1,5,66,72,2,6,1
16/09/2013,CMCO,GYNECO-OBSTETRIQUE,0,0,0,0,0,0,0
16/09/2013,SIHCUS/CMCO,GYNECOLOGIE ET OBSTETRIQUE - CMCO,0,0,0,0,0,0,0
15/09/2013,CCOM,CCOM Chirurgie,0,0,15,15,0,0,0
15/09/2013,CH Altkirch,Upatou,0,3,42,45,5,0,1
15/09/2013,CH de Colmar (CMC Le Parc),SAU Le Parc,13,0,45,58,6,0,0
15/09/2013,CH de Colmar (Louis Pasteur),SAU Pasteur,0,19,107,126,26,8,0
15/09/2013,CH de Guebwiller,UHTCD,1,4,42,47,2,2,1
15/09/2013,CH de Mulhouse ( Hasenrain),PEDIATRIE NEONATOLOGIE,8,0,24,32,3,1,0
15/09/2013,CH de Mulhouse (Emile Muller-Moenschberg,URGENCES,0,21,111,132,10,14,2
15/09/2013,CH de Saverne,S.A.U. (ADULTES),0,11,37,48,5,3,1
15/09/2013,CH de Saverne,PEDIATRIE,4,0,17,21,2,0,0
15/09/2013,CH de Thann,Urgences,0,5,31,36,4,1,1
15/09/2013,CH de Wissembourg,Urgences ,1,4,32,37,2,1,3
15/09/2013,CHU de Strasbourg (Hôp. Civil),Urgences Médico-Chirurgicales NHC,0,19,74,93,33,8,0
15/09/2013,CHU de Strasbourg(Hautepierre),Urgences chirurgicales pédiatriques,16,0,56,72,14,14,0
15/09/2013,CHU de Strasbourg(Hautepierre),Gynéco-Obstétrique (HTP),0,0,25,25,13,0,0
15/09/2013,CHU de Strasbourg(Hautepierre),Urgences chirurgicales pédiatriques,3,0,50,53,4,4,0
15/09/2013,CHU de Strasbourg(Hautepierre),Urgences Adulte HTP,0,20,67,87,26,0,1
15/09/2013,Clinique des 3 Frontières,UPATOU (Structure des urgences),2,2,48,52,3,0,0
15/09/2013,Clinique Ste Odile (Strasbourg,UPATOU,0,2,76,78,3,7,3
15/09/2013,CMCO,GYNECO-OBSTETRIQUE,0,0,0,0,0,0,0
15/09/2013,SIHCUS/CMCO,GYNECOLOGIE ET OBSTETRIQUE - CMCO,0,0,0,0,0,0,0
14/09/2013,CCOM,CCOM Chirurgie,0,2,17,19,3,0,0
14/09/2013,CH Altkirch,Upatou,0,4,33,37,3,0,2
14/09/2013,CH de Colmar (CMC Le Parc),SAU Le Parc,14,0,38,52,2,0,0
14/09/2013,CH de Colmar (Louis Pasteur),SAU Pasteur,0,20,126,146,25,11,1
14/09/2013,CH de Guebwiller,UHTCD,0,4,26,30,1,0,0
14/09/2013,CH de Mulhouse ( Hasenrain),PEDIATRIE NEONATOLOGIE,12,0,33,45,5,1,0
14/09/2013,CH de Mulhouse (Emile Muller-Moenschberg,URGENCES,2,23,107,132,16,12,4
14/09/2013,CH de Saverne,S.A.U. (ADULTES),0,5,41,46,10,3,1
14/09/2013,CH de Saverne,PEDIATRIE,8,0,15,23,0,0,0
14/09/2013,CH de Thann,Urgences,0,3,43,46,0,1,2
14/09/2013,CH de Wissembourg,Urgences ,2,5,31,38,7,0,0
14/09/2013,CHU de Strasbourg (Hôp. Civil),Urgences Médico-Chirurgicales NHC,0,18,94,112,48,8,1
14/09/2013,CHU de Strasbourg(Hautepierre),Urgences chirurgicales pédiatriques,1,0,43,44,1,1,0
14/09/2013,CHU de Strasbourg(Hautepierre),Urgences Adulte HTP,0,17,75,92,28,0,0
14/09/2013,CHU de Strasbourg(Hautepierre),Urgences chirurgicales pédiatriques,13,0,40,53,5,4,0
14/09/2013,CHU de Strasbourg(Hautepierre),Gynéco-Obstétrique (HTP),1,0,32,33,13,0,0
14/09/2013,Clinique des 3 Frontières,UPATOU (Structure des urgences),0,9,35,44,6,0,2
14/09/2013,Clinique Ste Odile (Strasbourg,UPATOU,1,5,66,72,0,6,3
14/09/2013,CMCO,GYNECO-OBSTETRIQUE,0,0,0,0,0,0,0
14/09/2013,SIHCUS/CMCO,GYNECOLOGIE ET OBSTETRIQUE - CMCO,0,0,0,0,0,0,0
13/09/2013,CCOM,CCOM Chirurgie,0,2,32,34,0,0,0
13/09/2013,CH Altkirch,Upatou,0,6,34,40,6,0,1
13/09/2013,CH de Colmar (CMC Le Parc),SAU Le Parc,2,0,32,34,1,0,0
13/09/2013,CH de Colmar (Louis Pasteur),SAU Pasteur,0,28,97,125,29,7,5
13/09/2013,CH de Guebwiller,UHTCD,0,5,37,42,1,1,0
13/09/2013,CH de Mulhouse ( Hasenrain),PEDIATRIE NEONATOLOGIE,11,0,17,28,3,1,0
13/09/2013,CH de Mulhouse (Emile Muller-Moenschberg,URGENCES,0,14,111,125,14,12,7
13/09/2013,CH de Saverne,S.A.U. (ADULTES),0,11,39,50,15,3,1
13/09/2013,CH de Saverne,PEDIATRIE,2,0,13,15,3,1,0
13/09/2013,CH de Thann,Urgences,0,1,35,36,1,0,0
13/09/2013,CH de Wissembourg,Urgences ,1,6,25,32,9,0,0
13/09/2013,CHU de Strasbourg (Hôp. Civil),Urgences Médico-Chirurgicales NHC,0,21,69,90,51,9,1
13/09/2013,CHU de Strasbourg(Hautepierre),Urgences chirurgicales pédiatriques,0,0,34,34,3,3,0
13/09/2013,CHU de Strasbourg(Hautepierre),Urgences Adulte HTP,0,14,71,85,36,0,1
13/09/2013,CHU de Strasbourg(Hautepierre),Urgences chirurgicales pédiatriques,12,0,38,50,8,8,0
13/09/2013,CHU de Strasbourg(Hautepierre),Gynéco-Obstétrique (HTP),1,0,21,22,11,0,0
13/09/2013,Clinique des 3 Frontières,UPATOU (Structure des urgences),1,5,34,40,3,0,2
13/09/2013,Clinique Ste Odile (Strasbourg,UPATOU,0,3,67,70,0,2,1
13/09/2013,CMCO,GYNECO-OBSTETRIQUE,0,0,0,0,0,0,0
13/09/2013,SIHCUS/CMCO,GYNECOLOGIE ET OBSTETRIQUE - CMCO,0,0,0,0,0,0,0
12/09/2013,CCOM,CCOM Chirurgie,0,1,15,16,1,0,0
12/09/2013,CH Altkirch,Upatou,0,6,30,36,2,1,2
12/09/2013,CH de Colmar (CMC Le Parc),SAU Le Parc,6,0,30,36,5,0,0
12/09/2013,CH de Colmar (Louis Pasteur),SAU Pasteur,0,24,79,103,19,7,0
12/09/2013,CH de Guebwiller,UHTCD,0,5,30,35,2,0,4
12/09/2013,CH de Mulhouse ( Hasenrain),PEDIATRIE NEONATOLOGIE,12,0,17,29,4,1,1
12/09/2013,CH de Mulhouse (Emile Muller-Moenschberg,URGENCES,0,21,83,104,13,12,1
12/09/2013,CH de Saverne,S.A.U. (ADULTES),0,8,34,42,7,1,0
12/09/2013,CH de Saverne,PEDIATRIE,5,0,19,24,1,1,0
12/09/2013,CH de Thann,Urgences,0,2,29,31,0,0,0
12/09/2013,CH de Wissembourg,Urgences ,0,7,20,27,7,0,0
12/09/2013,CHU de Strasbourg (Hôp. Civil),Urgences Médico-Chirurgicales NHC,0,9,59,68,34,3,1
12/09/2013,CHU de Strasbourg(Hautepierre),Urgences chirurgicales pédiatriques,11,0,21,32,4,4,0
12/09/2013,CHU de Strasbourg(Hautepierre),Gynéco-Obstétrique (HTP),1,0,33,34,16,0,0
12/09/2013,CHU de Strasbourg(Hautepierre),Urgences Adulte HTP,0,14,49,63,20,1,1
12/09/2013,CHU de Strasbourg(Hautepierre),Urgences chirurgicales pédiatriques,3,0,40,43,5,5,0
12/09/2013,Clinique des 3 Frontières,UPATOU (Structure des urgences),2,4,31,37,2,0,2
12/09/2013,Clinique Ste Odile (Strasbourg,UPATOU,0,3,53,56,1,9,1
12/09/2013,CMCO,GYNECO-OBSTETRIQUE,0,0,0,0,0,0,0
12/09/2013,SIHCUS/CMCO,GYNECOLOGIE ET OBSTETRIQUE - CMCO,0,0,0,0,0,0,0
11/09/2013,CCOM,CCOM Chirurgie,0,0,22,22,1,0,0
11/09/2013,CH Altkirch,Upatou,0,3,28,31,2,0,1
11/09/2013,CH de Colmar (CMC Le Parc),SAU Le Parc,5,0,29,34,7,0,0
11/09/2013,CH de Colmar (Louis Pasteur),SAU Pasteur,0,10,84,94,13,6,0
11/09/2013,CH de Guebwiller,UHTCD,0,2,33,35,2,1,1
11/09/2013,CH de Mulhouse ( Hasenrain),PEDIATRIE NEONATOLOGIE,6,0,19,25,4,1,0
11/09/2013,CH de Mulhouse (Emile Muller-Moenschberg,URGENCES,0,21,105,126,15,15,4
11/09/2013,CH de Saverne,PEDIATRIE,6,0,15,21,3,1,0
11/09/2013,CH de Saverne,S.A.U. (ADULTES),0,9,39,48,6,3,0
11/09/2013,CH de Thann,Urgences,1,8,30,39,2,0,0
11/09/2013,CH de Wissembourg,Urgences ,0,8,25,33,10,2,2
11/09/2013,CHU de Strasbourg (Hôp. Civil),Urgences Médico-Chirurgicales NHC,0,8,51,59,31,3,0
11/09/2013,CHU de Strasbourg(Hautepierre),Urgences chirurgicales pédiatriques,1,0,30,31,3,3,0
11/09/2013,CHU de Strasbourg(Hautepierre),Urgences chirurgicales pédiatriques,7,0,38,45,8,7,0
11/09/2013,CHU de Strasbourg(Hautepierre),Gynéco-Obstétrique (HTP),0,0,19,19,13,0,0
11/09/2013,CHU de Strasbourg(Hautepierre),Urgences Adulte HTP,1,13,69,83,28,0,1
11/09/2013,Clinique des 3 Frontières,UPATOU (Structure des urgences),1,2,38,41,2,0,2
11/09/2013,Clinique Ste Odile (Strasbourg,UPATOU,0,2,69,71,2,5,1
11/09/2013,CMCO,GYNECO-OBSTETRIQUE,0,0,0,0,0,0,0
11/09/2013,SIHCUS/CMCO,GYNECOLOGIE ET OBSTETRIQUE - CMCO,0,0,0,0,0,0,0
10/09/2013,CCOM,CCOM Chirurgie,0,2,24,26,3,0,0
10/09/2013,CH Altkirch,Upatou,0,4,32,36,4,2,0
10/09/2013,CH de Colmar (CMC Le Parc),SAU Le Parc,4,0,33,37,3,0,1
10/09/2013,CH de Colmar (Louis Pasteur),SAU Pasteur,0,15,85,100,17,11,0
10/09/2013,CH de Guebwiller,UHTCD,0,2,30,32,0,4,1
10/09/2013,CH de Mulhouse ( Hasenrain),PEDIATRIE NEONATOLOGIE,9,0,24,33,6,3,0
10/09/2013,CH de Mulhouse (Emile Muller-Moenschberg,URGENCES,0,18,90,108,11,12,6
10/09/2013,CH de Saverne,S.A.U. (ADULTES),0,7,33,40,8,2,2
10/09/2013,CH de Saverne,PEDIATRIE,2,0,8,10,3,0,0
10/09/2013,CH de Thann,Urgences,0,3,18,21,3,0,0
10/09/2013,CH de Wissembourg,Urgences ,0,8,22,30,11,3,0
10/09/2013,CHU de Strasbourg (Hôp. Civil),Urgences Médico-Chirurgicales NHC,0,16,51,67,35,4,3
10/09/2013,CHU de Strasbourg(Hautepierre),Urgences chirurgicales pédiatriques,15,0,37,52,5,5,0
10/09/2013,CHU de Strasbourg(Hautepierre),Gynéco-Obstétrique (HTP),0,0,20,20,6,0,0
10/09/2013,CHU de Strasbourg(Hautepierre),Urgences chirurgicales pédiatriques,2,0,41,43,3,3,0
10/09/2013,CHU de Strasbourg(Hautepierre),Urgences Adulte HTP,0,16,67,83,28,0,0
10/09/2013,Clinique des 3 Frontières,UPATOU (Structure des urgences),0,5,33,38,5,0,1
10/09/2013,Clinique Ste Odile (Strasbourg,UPATOU,0,2,63,65,1,1,3
10/09/2013,CMCO,GYNECO-OBSTETRIQUE,0,0,0,0,0,0,0
10/09/2013,SIHCUS/CMCO,GYNECOLOGIE ET OBSTETRIQUE - CMCO,0,0,0,0,0,0,0
9/09/2013,CCOM,CCOM Chirurgie,0,2,26,28,3,0,0
9/09/2013,CH Altkirch,Upatou,0,5,36,41,3,0,2
9/09/2013,CH de Colmar (CMC Le Parc),SAU Le Parc,3,0,33,36,5,0,0
9/09/2013,CH de Colmar (Louis Pasteur),SAU Pasteur,0,23,118,141,14,7,0
9/09/2013,CH de Guebwiller,UHTCD,0,7,38,45,0,2,1
9/09/2013,CH de Mulhouse ( Hasenrain),PEDIATRIE NEONATOLOGIE,12,0,21,33,5,0,0
9/09/2013,CH de Mulhouse (Emile Muller-Moenschberg,URGENCES,2,19,110,131,12,14,3
9/09/2013,CH de Saverne,PEDIATRIE,3,0,10,13,4,0,0
9/09/2013,CH de Saverne,S.A.U. (ADULTES),0,11,53,64,11,3,0
9/09/2013,CH de Thann,Urgences,0,11,37,48,8,2,0
9/09/2013,CH de Wissembourg,Urgences ,1,8,37,46,10,0,2
9/09/2013,CHU de Strasbourg (Hôp. Civil),Urgences Médico-Chirurgicales NHC,0,7,67,74,34,10,0
9/09/2013,CHU de Strasbourg(Hautepierre),Urgences chirurgicales pédiatriques,7,0,25,32,2,3,0
9/09/2013,CHU de Strasbourg(Hautepierre),Gynéco-Obstétrique (HTP),2,0,27,29,11,0,0
9/09/2013,CHU de Strasbourg(Hautepierre),Urgences chirurgicales pédiatriques,2,0,43,45,7,7,0
9/09/2013,CHU de Strasbourg(Hautepierre),Urgences Adulte HTP,0,14,85,99,48,0,0
9/09/2013,Clinique des 3 Frontières,UPATOU (Structure des urgences),0,5,36,41,9,0,0
9/09/2013,CMCO,GYNECO-OBSTETRIQUE,0,0,0,0,0,0,0
9/09/2013,SIHCUS/CMCO,GYNECOLOGIE ET OBSTETRIQUE - CMCO,0,0,0,0,0,0,0
8/09/2013,CCOM,CCOM Chirurgie,0,0,18,18,1,0,0
8/09/2013,CH Altkirch,Upatou,0,6,34,40,3,1,0
8/09/2013,CH de Colmar (CMC Le Parc),SAU Le Parc,4,0,41,45,4,0,0
8/09/2013,CH de Colmar (Louis Pasteur),SAU Pasteur,0,18,129,147,17,11,0
8/09/2013,CH de Guebwiller,UHTCD,0,4,44,48,3,3,1
8/09/2013,CH de Mulhouse ( Hasenrain),PEDIATRIE NEONATOLOGIE,4,0,29,33,4,0,0
8/09/2013,CH de Mulhouse (Emile Muller-Moenschberg,URGENCES,2,15,120,137,15,13,0
8/09/2013,CH de Saverne,S.A.U. (ADULTES),0,10,38,48,10,3,0
8/09/2013,CH de Saverne,PEDIATRIE,1,0,21,22,2,0,0
8/09/2013,CH de Thann,Urgences,0,5,52,57,1,3,0
8/09/2013,CH de Wissembourg,Urgences ,0,3,33,36,3,0,0
8/09/2013,CHU de Strasbourg (Hôp. Civil),Urgences Médico-Chirurgicales NHC,0,9,65,74,28,2,0
8/09/2013,CHU de Strasbourg(Hautepierre),Urgences chirurgicales pédiatriques,7,0,45,52,9,8,0
8/09/2013,CHU de Strasbourg(Hautepierre),Gynéco-Obstétrique (HTP),0,0,26,26,10,0,0
8/09/2013,CHU de Strasbourg(Hautepierre),Urgences Adulte HTP,0,14,94,108,37,0,0
8/09/2013,CHU de Strasbourg(Hautepierre),Urgences chirurgicales pédiatriques,1,0,57,58,6,5,0
8/09/2013,Clinique des 3 Frontières,UPATOU (Structure des urgences),0,4,55,59,5,0,1
8/09/2013,CMCO,GYNECO-OBSTETRIQUE,0,0,0,0,0,0,0
8/09/2013,SIHCUS/CMCO,GYNECOLOGIE ET OBSTETRIQUE - CMCO,0,0,0,0,0,0,0
7/09/2013,CCOM,CCOM Chirurgie,0,0,19,19,1,0,0
7/09/2013,CH Altkirch,Upatou,0,3,37,40,4,3,1
7/09/2013,CH de Colmar (CMC Le Parc),SAU Le Parc,4,0,46,50,6,0,0
7/09/2013,CH de Colmar (Louis Pasteur),SAU Pasteur,0,16,104,120,19,8,4
7/09/2013,CH de Guebwiller,UHTCD,0,4,45,49,0,1,1
7/09/2013,CH de Mulhouse ( Hasenrain),PEDIATRIE NEONATOLOGIE,12,0,23,35,1,1,0
7/09/2013,CH de Mulhouse (Emile Muller-Moenschberg,URGENCES,1,29,118,148,21,7,5
7/09/2013,CH de Saverne,S.A.U. (ADULTES),0,8,56,64,10,6,0
7/09/2013,CH de Saverne,PEDIATRIE,1,0,13,14,2,1,0
7/09/2013,CH de Thann,Urgences,2,5,44,51,1,1,4
7/09/2013,CH de Wissembourg,Urgences ,1,7,27,35,5,2,0
7/09/2013,CHU de Strasbourg (Hôp. Civil),Urgences Médico-Chirurgicales NHC,1,22,82,105,48,3,0
7/09/2013,CHU de Strasbourg(Hautepierre),Urgences chirurgicales pédiatriques,11,0,43,54,7,6,0
7/09/2013,CHU de Strasbourg(Hautepierre),Gynéco-Obstétrique (HTP),0,0,22,22,8,0,0
7/09/2013,CHU de Strasbourg(Hautepierre),Urgences Adulte HTP,0,15,81,96,30,0,0
7/09/2013,CHU de Strasbourg(Hautepierre),Urgences chirurgicales pédiatriques,3,0,45,48,5,5,0
7/09/2013,Clinique des 3 Frontières,UPATOU (Structure des urgences),1,3,49,53,3,0,0
7/09/2013,Clinique des Diaconesses,SOS Main,0,0,27,27,0,0,0
7/09/2013,Clinique Ste Odile (Strasbourg,UPATOU,0,3,70,73,0,4,2
7/09/2013,CMCO,GYNECO-OBSTETRIQUE,0,0,0,0,0,0,0
7/09/2013,SIHCUS/CMCO,GYNECOLOGIE ET OBSTETRIQUE - CMCO,0,0,0,0,0,0,0
6/09/2013,CCOM,CCOM Chirurgie,0,0,26,26,3,0,0
6/09/2013,CH Altkirch,Upatou,0,5,29,34,7,1,1
6/09/2013,CH de Colmar (CMC Le Parc),SAU Le Parc,2,0,37,39,4,0,1
6/09/2013,CH de Colmar (Louis Pasteur),SAU Pasteur,0,21,106,127,27,11,1
6/09/2013,CH de Guebwiller,UHTCD,0,5,33,38,3,2,1
6/09/2013,CH de Mulhouse ( Hasenrain),PEDIATRIE NEONATOLOGIE,7,0,20,27,6,1,0
6/09/2013,CH de Mulhouse (Emile Muller-Moenschberg,URGENCES,0,22,116,138,8,18,8
6/09/2013,CH de Saverne,S.A.U. (ADULTES),0,10,37,47,13,4,2
6/09/2013,CH de Saverne,PEDIATRIE,5,0,18,23,0,1,0
6/09/2013,CH de Thann,Urgences,0,8,31,39,1,1,0
6/09/2013,CH de Wissembourg,Urgences ,0,4,31,35,7,0,0
6/09/2013,CHU de Strasbourg (Hôp. Civil),Urgences Médico-Chirurgicales NHC,0,21,64,85,52,0,3
6/09/2013,CHU de Strasbourg(Hautepierre),Urgences chirurgicales pédiatriques,14,0,30,44,10,10,0
6/09/2013,CHU de Strasbourg(Hautepierre),Gynéco-Obstétrique (HTP),0,0,27,27,16,0,0
6/09/2013,CHU de Strasbourg(Hautepierre),Urgences Adulte HTP,0,13,75,88,26,0,0
6/09/2013,CHU de Strasbourg(Hautepierre),Urgences chirurgicales pédiatriques,2,0,51,53,3,3,0
6/09/2013,Clinique des 3 Frontières,UPATOU (Structure des urgences),0,3,31,34,2,0,0
6/09/2013,Clinique des Diaconesses,SOS Main,0,0,23,23,0,0,0
6/09/2013,Clinique Ste Odile (Strasbourg,UPATOU,2,4,75,81,1,9,8
6/09/2013,CMCO,GYNECO-OBSTETRIQUE,0,0,0,0,0,0,0
6/09/2013,SIHCUS/CMCO,GYNECOLOGIE ET OBSTETRIQUE - CMCO,0,0,0,0,0,0,0
5/09/2013,CCOM,CCOM Chirurgie,0,2,29,31,1,0,0
5/09/2013,CH Altkirch,Upatou,0,4,30,34,2,1,2
5/09/2013,CH de Colmar (CMC Le Parc),SAU Le Parc,9,0,37,46,7,0,2
5/09/2013,CH de Colmar (Louis Pasteur),SAU Pasteur,0,26,104,130,15,12,0
5/09/2013,CH de Guebwiller,UHTCD,0,5,35,40,1,3,3
5/09/2013,CH de Mulhouse ( Hasenrain),PEDIATRIE NEONATOLOGIE,12,0,16,28,6,1,0
5/09/2013,CH de Mulhouse (Emile Muller-Moenschberg,URGENCES,0,21,118,139,18,11,6
5/09/2013,CH de Saverne,PEDIATRIE,7,0,13,20,2,3,0
5/09/2013,CH de Saverne,S.A.U. (ADULTES),0,14,37,51,11,5,2
5/09/2013,CH de Thann,Urgences,0,11,20,31,5,1,2
5/09/2013,CH de Wissembourg,Urgences ,0,4,24,28,8,0,0
5/09/2013,CHU de Strasbourg (Hôp. Civil),Urgences Médico-Chirurgicales NHC,0,12,58,70,27,10,0
5/09/2013,CHU de Strasbourg(Hautepierre),Gynéco-Obstétrique (HTP),0,0,23,23,9,0,0
5/09/2013,CHU de Strasbourg(Hautepierre),Urgences Adulte HTP,0,18,88,106,41,0,0
5/09/2013,CHU de Strasbourg(Hautepierre),Urgences chirurgicales pédiatriques,3,0,49,52,4,4,0
5/09/2013,CHU de Strasbourg(Hautepierre),Urgences chirurgicales pédiatriques,10,0,31,41,2,3,0
5/09/2013,Clinique des 3 Frontières,UPATOU (Structure des urgences),0,3,44,47,5,0,0
5/09/2013,Clinique des Diaconesses,SOS Main,0,2,32,34,14,0,0
5/09/2013,Clinique Ste Odile (Strasbourg,UPATOU,0,5,57,62,1,6,3
5/09/2013,CMCO,GYNECO-OBSTETRIQUE,0,0,0,0,0,0,0
5/09/2013,SIHCUS/CMCO,GYNECOLOGIE ET OBSTETRIQUE - CMCO,0,0,0,0,0,0,0
4/09/2013,CCOM,CCOM Chirurgie,0,0,29,29,5,0,0
4/09/2013,CH Altkirch,Upatou,0,3,32,35,5,1,1
4/09/2013,CH de Colmar (CMC Le Parc),SAU Le Parc,6,0,33,39,2,0,0
4/09/2013,CH de Colmar (Louis Pasteur),SAU Pasteur,0,24,111,135,16,12,0
4/09/2013,CH de Guebwiller,UHTCD,0,3,28,31,2,0,2
4/09/2013,CH de Mulhouse ( Hasenrain),PEDIATRIE NEONATOLOGIE,6,0,28,34,3,0,0
4/09/2013,CH de Mulhouse (Emile Muller-Moenschberg,URGENCES,2,24,103,129,28,10,1
4/09/2013,CH de Saverne,PEDIATRIE,4,0,16,20,2,0,0
4/09/2013,CH de Saverne,S.A.U. (ADULTES),0,5,38,43,6,4,1
4/09/2013,CH de Thann,Urgences,0,2,34,36,1,1,1
4/09/2013,CH de Wissembourg,Urgences ,0,3,31,34,2,0,0
4/09/2013,CHU de Strasbourg (Hôp. Civil),Urgences Médico-Chirurgicales NHC,0,18,63,81,35,2,0
4/09/2013,CHU de Strasbourg(Hautepierre),Urgences Adulte HTP,0,16,54,70,34,0,2
4/09/2013,CHU de Strasbourg(Hautepierre),Urgences chirurgicales pédiatriques,6,0,41,47,4,4,0
4/09/2013,CHU de Strasbourg(Hautepierre),Urgences chirurgicales pédiatriques,8,0,30,38,3,3,0
4/09/2013,CHU de Strasbourg(Hautepierre),Gynéco-Obstétrique (HTP),1,0,20,21,11,0,0
4/09/2013,Clinique des 3 Frontières,UPATOU (Structure des urgences),0,3,34,37,4,0,0
4/09/2013,Clinique des Diaconesses,SOS Main,0,0,36,36,11,0,0
4/09/2013,Clinique Ste Odile (Strasbourg,UPATOU,0,2,61,63,1,9,0
4/09/2013,CMCO,GYNECO-OBSTETRIQUE,0,0,0,0,0,0,0
4/09/2013,SIHCUS/CMCO,GYNECOLOGIE ET OBSTETRIQUE - CMCO,0,0,0,0,0,0,0
3/09/2013,CCOM,CCOM Chirurgie,0,3,23,26,3,0,0
3/09/2013,CH Altkirch,Upatou,0,6,22,28,6,0,0
3/09/2013,CH de Colmar (CMC Le Parc),SAU Le Parc,2,0,20,22,6,0,0
3/09/2013,CH de Colmar (Louis Pasteur),SAU Pasteur,0,21,124,145,15,13,1
3/09/2013,CH de Guebwiller,UHTCD,0,8,22,30,2,1,2
3/09/2013,CH de Mulhouse ( Hasenrain),PEDIATRIE NEONATOLOGIE,6,0,22,28,4,0,0
3/09/2013,CH de Mulhouse (Emile Muller-Moenschberg,URGENCES,2,17,105,124,14,17,7
3/09/2013,CH de Saverne,PEDIATRIE,5,0,10,15,5,0,0
3/09/2013,CH de Saverne,S.A.U. (ADULTES),0,14,36,50,16,1,0
3/09/2013,CH de Thann,Urgences,1,5,38,44,5,0,2
3/09/2013,CH de Wissembourg,Urgences ,1,8,30,39,8,1,2
3/09/2013,CHU de Strasbourg (Hôp. Civil),Urgences Médico-Chirurgicales NHC,0,18,62,80,44,0,0
3/09/2013,CHU de Strasbourg(Hautepierre),Urgences chirurgicales pédiatriques,1,0,42,43,4,5,0
3/09/2013,CHU de Strasbourg(Hautepierre),Urgences chirurgicales pédiatriques,3,0,23,26,6,6,0
3/09/2013,CHU de Strasbourg(Hautepierre),Gynéco-Obstétrique (HTP),0,1,30,31,12,0,0
3/09/2013,CHU de Strasbourg(Hautepierre),Urgences Adulte HTP,0,14,68,82,29,0,1
3/09/2013,Clinique des Diaconesses,SOS Main,0,0,37,37,9,0,0
3/09/2013,Clinique Ste Odile (Strasbourg,UPATOU,0,5,57,62,2,8,3
3/09/2013,CMCO,GYNECO-OBSTETRIQUE,0,0,0,0,0,0,0
3/09/2013,SIHCUS/CMCO,GYNECOLOGIE ET OBSTETRIQUE - CMCO,0,0,0,0,0,0,0
2/09/2013,CCOM,CCOM Chirurgie,0,1,33,34,3,0,0
2/09/2013,CH Altkirch,Upatou,1,6,32,39,6,2,3
2/09/2013,CH de Colmar (CMC Le Parc),SAU Le Parc,3,0,28,31,3,0,0
2/09/2013,CH de Colmar (Louis Pasteur),SAU Pasteur,0,27,111,138,12,6,0
2/09/2013,CH de Guebwiller,UHTCD,0,6,39,45,2,2,1
2/09/2013,CH de Mulhouse ( Hasenrain),PEDIATRIE NEONATOLOGIE,7,0,22,29,1,1,0
2/09/2013,CH de Mulhouse (Emile Muller-Moenschberg,URGENCES,0,22,114,136,9,12,3
2/09/2013,CH de Saverne,PEDIATRIE,4,0,14,18,3,0,0
2/09/2013,CH de Saverne,S.A.U. (ADULTES),0,14,49,63,11,4,0
2/09/2013,CH de Thann,Urgences,0,5,32,37,2,0,2
2/09/2013,CH de Wissembourg,Urgences ,1,10,63,74,19,0,2
2/09/2013,CHU de Strasbourg (Hôp. Civil),Urgences Médico-Chirurgicales NHC,0,23,61,84,46,4,3
2/09/2013,CHU de Strasbourg(Hautepierre),Gynéco-Obstétrique (HTP),2,0,28,30,10,0,0
2/09/2013,CHU de Strasbourg(Hautepierre),Urgences chirurgicales pédiatriques,1,0,44,45,5,5,0
2/09/2013,CHU de Strasbourg(Hautepierre),Urgences Adulte HTP,0,15,75,90,36,0,1
2/09/2013,CHU de Strasbourg(Hautepierre),Urgences chirurgicales pédiatriques,9,0,20,29,4,4,0
2/09/2013,Clinique des 3 Frontières,UPATOU (Structure des urgences),0,4,34,38,3,0,0
2/09/2013,Clinique Ste Odile (Strasbourg,UPATOU,0,6,68,74,3,6,1
2/09/2013,CMCO,GYNECO-OBSTETRIQUE,0,0,0,0,0,0,0
2/09/2013,SIHCUS/CMCO,GYNECOLOGIE ET OBSTETRIQUE - CMCO,0,0,0,0,0,0,0
1/09/2013,CCOM,CCOM Chirurgie,0,0,20,20,1,0,0
1/09/2013,CH Altkirch,Upatou,0,5,34,39,2,0,2
1/09/2013,CH de Colmar (CMC Le Parc),SAU Le Parc,5,0,37,42,4,0,0
1/09/2013,CH de Colmar (Louis Pasteur),SAU Pasteur,0,22,113,135,15,14,1
1/09/2013,CH de Guebwiller,UHTCD,0,4,43,47,0,2,2
1/09/2013,CH de Mulhouse ( Hasenrain),PEDIATRIE NEONATOLOGIE,10,0,21,31,2,1,1
1/09/2013,CH de Mulhouse (Emile Muller-Moenschberg,URGENCES,1,14,107,122,17,7,4
1/09/2013,CH de Saverne,PEDIATRIE,2,0,21,23,5,0,0
1/09/2013,CH de Saverne,S.A.U. (ADULTES),0,7,48,55,8,5,1
1/09/2013,CH de Thann,Urgences,0,8,32,40,2,0,6
1/09/2013,CH de Wissembourg,Urgences ,0,3,33,36,7,0,2
1/09/2013,CHU de Strasbourg (Hôp. Civil),Urgences Médico-Chirurgicales NHC,0,11,61,72,15,3,1
1/09/2013,CHU de Strasbourg(Hautepierre),Urgences Adulte HTP,0,21,79,100,37,0,0
1/09/2013,CHU de Strasbourg(Hautepierre),Urgences chirurgicales pédiatriques,13,0,34,47,5,5,0
1/09/2013,CHU de Strasbourg(Hautepierre),Gynéco-Obstétrique (HTP),1,0,17,18,5,0,0
1/09/2013,CHU de Strasbourg(Hautepierre),Urgences chirurgicales pédiatriques,4,0,50,54,5,5,0
1/09/2013,Clinique des 3 Frontières,UPATOU (Structure des urgences),0,2,42,44,3,0,1
1/09/2013,Clinique Ste Odile (Strasbourg,UPATOU,1,2,81,84,1,2,1
1/09/2013,CMCO,GYNECO-OBSTETRIQUE,0,0,0,0,0,0,0
1/09/2013,SIHCUS/CMCO,GYNECOLOGIE ET OBSTETRIQUE - CMCO,0,0,0,0,0,0,0
